あーん	aː ɴ
あけらかん	a k e ɾ a k a ɴ
あざあざ	a z aː z a
あたふた	a t a ɸ ɯ t a
あっけらかん	a k k e ɾ a k a ɴ
あっさり	a s s a ɾʲ i
あっぷあっぷ	a p p ɯ a p p ɯ
あはは	a h a h a
あぶあぶ	a b ɯ a b ɯ
あぷあぷ	a p ɯ a p ɯ
あんあん	a ɰ̃ a ɴ
あんぐり	a ŋ ɡ ɯ ɾʲ i
いがいが	i ɡ a i ɡ a
いけしゃーしゃー	i k e ɕ aː ɕ aː
いじいじ	i ʑ iː ʑ i
いそいそ	i s o i s o
いちゃいちゃ	i tɕ a i tɕ a
いひひ	i ç i ç i
いらいら	i ɾ a i ɾ a
うー	ɯː
うーん	ɯː ɴ
うかうか	ɯ k a ɯ k a
うかと	ɯ k a t o
うきうき	ɯ c i ɯ c i
うざうざ	ɯ z a ɯ z a
うじうじ	ɯ ʑ i ɯ ʑ i
うじゃうじゃ	ɯ ʑ a ɯ ʑ a
うずうず	ɯ z ɯː z ɯ
うだうだ	ɯ d a ɯ d a
うっ	ɯ ʔ
うっかり	ɯ k k a ɾʲ i
うっすら	ɯ s s ɯ ɾ a
うっすり	ɯ s s ɯ ɾʲ i
うっとり	ɯ t t o ɾʲ i
うつらうつら	ɯ ts ɯ ɾ a ɯ ts ɯ ɾ a
うとうと	ɯ t o ɯ t o
うねうね	ɯ n e ɯ n e
うはうは	ɯ h a ɯ h a
うふふ	ɯ ɸ ɯ ɸ ɯ
うようよ	ɯ j o ɯ j o
うらうら	ɯ ɾ a ɯ ɾ a
うるうる	ɯ ɾ ɯː ɾ ɯ
うるっ	ɯ ɾ ɯ ʔ
うろうろ	ɯ ɾ o ɯ ɾ o
うろちょろ	ɯ ɾ o tɕ o ɾ o
うん	ɯ ɴ
うんうん	ɯ ɰ̃ ɯ ɴ
うんざり	ɯ n dz a ɾʲ i
えっちらおっちら	e t tɕ i ɾ a o t tɕ i ɾ a
えへへ	e h e h e
えへらえへら	e h e ɾ a e h e ɾ a
えへん	e h e ŋ
えんえん	e ɰ̃ e ŋ
おいおい	o i o i
おうおう	o ɯ o ɯ
おぎゃー	o ɟ aː
おずおず	o z ɯ o z ɯ
おたおた	o t a o t a
おちおち	o tɕ i o tɕ i
おっとり	o t t o ɾʲ i
おどおど	o d oː d o
おぼおぼ	o b oː b o
おほほ	o h o h o
おめおめ	o m e o m e
おろおろ	o ɾ oː ɾ o
おんおん	o ɰ̃ o ɴ
かー	k aː
かーかー	k aː k aː
がーがー	ɡ aː ɡ aː
かーん	k aː ɴ
がーん	ɡ aː ɴ
かいよ	k a i j o
がくがく	ɡ a k ɯ ɡ a k ɯ
がくっ	ɡ a k ɯ ʔ
がくり	ɡ a k ɯ ɾʲ i
がくん	ɡ a k ɯ ɴ
かさかさ	k a s a k a s a
がさがさ	ɡ a s a ɡ a s a
かさこそ	k a s a k o s o
がさごそ	ɡ a s a ɡ o s o
がさり	ɡ a s a ɾʲ i
がしがし	ɡ a ɕ i ɡ a ɕ i
がじがじ	ɡ a ʑ i ɡ a ʑ i
がしっ	ɡ a ɕ i ʔ
がしゃがしゃ	ɡ a ɕ a ɡ a ɕ a
がしゃん	ɡ a ɕ a ɴ
かすかす	k a s ɯ k a s ɯ
がた	ɡ a t a
かたかた	k a t a k a t a
がたがた	ɡ a t a ɡ a t a
がたくり	ɡ a t a k ɯ ɾʲ i
かたこと	k a t a k o t o
がたごと	ɡ a t a ɡ o t o
がたぴし	ɡ a t a pʲ i ɕ i
がたぴち	ɡ a t a pʲ i tɕ i
かたり	k a t a ɾʲ i
がたり	ɡ a t a ɾʲ i
かたん	k a t a ɴ
がたん	ɡ a t a ɴ
かちかち	k a tɕ i k a tɕ i
がちがち	ɡ a tɕ i ɡ a tɕ i
かちっ	k a tɕ i ʔ
がちっ	ɡ a tɕ i ʔ
がちゃ	ɡ a tɕ a
かちゃかちゃ	k a tɕ a k a tɕ a
がちゃがちゃ	ɡ a tɕ a ɡ a tɕ a
かちゃっ	k a tɕ a ʔ
がちゃっ	ɡ a tɕ a ʔ
かちゃり	k a tɕ a ɾʲ i
がちゃり	ɡ a tɕ a ɾʲ i
かちゃん	k a tɕ a ɴ
がちゃん	ɡ a tɕ a ɴ
かちり	k a tɕ i ɾʲ i
がちり	ɡ a tɕ i ɾʲ i
かちん	k a tɕ i ŋ
がちん	ɡ a tɕ i ŋ
かちんかちん	k a tɕ i ŋ k a tɕ i ŋ
かっ	k a ʔ
がっ	ɡ a ʔ
かっか	k a k k a
かっかっ	k a k k a ʔ
かつかつ	k a ts ɯ k a ts ɯ
がつがつ	ɡ a ts ɯ ɡ a ts ɯ
がっかり	ɡ a k k a ɾʲ i
かっきり	k a c c i ɾʲ i
がっくり	ɡ a k k ɯ ɾʲ i
がっしり	ɡ a ɕ ɕ i ɾʲ i
がったり	ɡ a t t a ɾʲ i
かったん	k a t t a ɴ
がっちゃん	ɡ a t tɕ a ɴ
かっちり	k a t tɕ i ɾʲ i
がっちり	ɡ a t tɕ i ɾʲ i
がっぷり	ɡ a p p ɯ ɾʲ i
がっぽがっぽ	ɡ a p p o ɡ a p p o
がっぽり	ɡ a p p o ɾʲ i
がつん	ɡ a ts ɯ ɴ
かなかな	k a n a k a n a
がばがば	ɡ a b a ɡ a b a
がはは	ɡ a h a h a
がばり	ɡ a b a ɾʲ i
がぶがぶ	ɡ a b ɯ ɡ a b ɯ
がぶっ	ɡ a b ɯ ʔ
がぶり	ɡ a b ɯ ɾʲ i
がぼがぼ	ɡ a b o ɡ a b o
がみがみ	ɡ a mʲ i ɡ a mʲ i
がやがや	ɡ a j a ɡ a j a
からから	k a ɾ a k a ɾ a
がらがら	ɡ a ɾ a ɡ a ɾ a
からころ	k a ɾ a k o ɾ o
からっ	k a ɾ a ʔ
がらっ	ɡ a ɾ a ʔ
からり	k a ɾ a ɾʲ i
がらり	ɡ a ɾ a ɾʲ i
からりからり	k a ɾ a ɾʲ i k a ɾ a ɾʲ i
がらりがらり	ɡ a ɾ a ɾʲ i ɡ a ɾ a ɾʲ i
からりころり	k a ɾ a ɾʲ i k o ɾ o ɾʲ i
からん	k a ɾ a ɴ
がらん	ɡ a ɾ a ɴ
からんころん	k a ɾ a ŋ k o ɾ o ɴ
かりかり	k a ɾʲ i k a ɾʲ i
がりがり	ɡ a ɾʲ i ɡ a ɾʲ i
かりっ	k a ɾʲ i ʔ
がりっ	ɡ a ɾʲ i ʔ
かん	k a ɴ
がん	ɡ a ɴ
かんかん	k a ŋ k a ɴ
がんがん	ɡ a ŋ ɡ a ɴ
きー	c iː
ぎー	ɟ iː
きーきー	c iː c iː
ぎーぎー	ɟ iː ɟ iː
きーん	c iː ŋ
ぎく	ɟ i k ɯ
ぎくぎく	ɟ i k ɯ ɟ i k ɯ
ぎくしゃく	ɟ i k ɯ ɕ a k ɯ
ぎくっ	ɟ i k ɯ ʔ
ぎくり	ɟ i k ɯ ɾʲ i
ぎくん	ɟ i k ɯ ɴ
ぎこぎこ	ɟ i k o ɟ i k o
きざきざ	c i z a c i z a
ぎざぎざ	ɟ i z a ɟ i z a
きしきし	c i ɕ i c i ɕ i
ぎしぎし	ɟ i ɕ i ɟ i ɕ i
ぎすぎす	ɟ i s ɯ ɟ i s ɯ
きちきち	c i tɕ i c i tɕ i
ぎちぎち	ɟ i tɕ i ɟ i tɕ i
きちっ	c i tɕ i ʔ
きちり	c i tɕ i ɾʲ i
きっ	c i ʔ
ぎっ	ɟ i ʔ
きっかり	c i k k a ɾʲ i
ぎっくり	ɟ i k k ɯ ɾʲ i
きっしり	c i ɕ ɕ i ɾʲ i
ぎっしり	ɟ i ɕ ɕ i ɾʲ i
きっちり	c i t tɕ i ɾʲ i
ぎっちり	ɟ i t tɕ i ɾʲ i
きっぱり	c i p p a ɾʲ i
ぎとぎと	ɟ i t o ɟ i t o
きびきび	c i bʲ i c i bʲ i
きゃー	c aː
ぎゃー	ɟ aː
きゃーきゃー	c aː c aː
ぎゃーぎゃー	ɟ aː ɟ aː
きゃっ	c a ʔ
きゃっきゃっ	c a c c a ʔ
ぎゃふん	ɟ a ɸ ɯ ɴ
きゃん	c a ɴ
きゃんきゃん	c a ŋ c a ɴ
ぎゃんぎゃん	ɟ a ŋ ɟ a ɴ
きゅー	c ɯː
ぎゅー	ɟ ɯː
きゅーきゅー	c ɯː c ɯː
ぎゅーぎゅー	ɟ ɯː ɟ ɯː
きゅっ	c ɯ ʔ
ぎゅっ	ɟ ɯ ʔ
きゅっきゅっ	c ɯ c c ɯ ʔ
ぎゅっぎゅっ	ɟ ɯ ɟ ɟ ɯ ʔ
きゅん	c ɯ ɴ
ぎゅん	ɟ ɯ ɴ
ぎょっ	ɟ o ʔ
きょときょと	c o t o c o t o
きょとん	c o t o ɴ
きょろきょろ	c o ɾ o c o ɾ o
ぎょろぎょろ	ɟ o ɾ o ɟ o ɾ o
ぎょろっ	ɟ o ɾ o ʔ
きょろり	c o ɾ o ɾʲ i
ぎょろり	ɟ o ɾ o ɾʲ i
きらきら	c i ɾ a c i ɾ a
ぎらぎら	ɟ i ɾ a ɟ i ɾ a
きらっ	c i ɾ a ʔ
きらり	c i ɾ a ɾʲ i
ぎらり	ɟ i ɾ a ɾʲ i
きりきり	c i ɾʲ i c i ɾʲ i
ぎりぎり	ɟ i ɾʲ i ɟ i ɾʲ i
きりきりしゃん	c i ɾʲ i c i ɾʲ i ɕ a ɴ
きりっ	c i ɾʲ i ʔ
ぎりっ	ɟ i ɾʲ i ʔ
きりり	c i ɾʲ i ɾʲ i
ぎりり	ɟ i ɾʲ i ɾʲ i
きりりしゃん	c i ɾʲ i ɾʲ i ɕ a ɴ
きろきろ	c i ɾ o c i ɾ o
きん	c i ŋ
きんきら	c i ŋ c i ɾ a
きんきらきん	c i ŋ c i ɾ a c i ŋ
ぎんぎらぎん	ɟ i ŋ ɟ i ɾ a ɟ i ŋ
きんきん	c i ŋ c i ŋ
ぎんぎん	ɟ i ŋ ɟ i ŋ
くい	k ɯ i
ぐい	ɡ ɯ i
くいくい	k ɯ i k ɯ i
ぐいぐい	ɡ ɯ i ɡ ɯ i
ぐー	ɡ ɯː
くーくー	k ɯː k ɯː
ぐーぐー	ɡ ɯː ɡ ɯː
ぐーすか	ɡ ɯː s ɯ k a
ぐーっ	ɡ ɯː ʔ
くさくさ	k ɯ s a k ɯ s a
ぐさぐさ	ɡ ɯ s a ɡ ɯ s a
ぐさっ	ɡ ɯ s a ʔ
ぐさり	ɡ ɯ s a ɾʲ i
くしゃくしゃ	k ɯ ɕ a k ɯ ɕ a
ぐしゃぐしゃ	ɡ ɯ ɕ a ɡ ɯ ɕ a
ぐじゃぐじゃ	ɡ ɯ ʑ a ɡ ɯ ʑ a
ぐしゃっ	ɡ ɯ ɕ a ʔ
ぐしゃり	ɡ ɯ ɕ a ɾʲ i
くしゃん	k ɯ ɕ a ɴ
ぐしょぐしょ	ɡ ɯ ɕ o ɡ ɯ ɕ o
ぐじょぐじょ	ɡ ɯ ʑ o ɡ ɯ ʑ o
くすくす	k ɯ s ɯ k ɯ s ɯ
ぐすぐす	ɡ ɯ s ɯ ɡ ɯ s ɯ
ぐずぐず	ɡ ɯ z ɯ ɡ ɯ z ɯ
くすっ	k ɯ s ɯ ʔ
くすり	k ɯ s ɯ ɾʲ i
くすん	k ɯ s ɯ ɴ
くたくた	k ɯ t a k ɯ t a
くだくだ	k ɯ d a k ɯ d a
ぐたぐた	ɡ ɯ t a ɡ ɯ t a
ぐだぐだ	ɡ ɯ d a ɡ ɯ d a
ぐたっ	ɡ ɯ t a ʔ
ぐたり	ɡ ɯ t a ɾʲ i
くちゃくちゃ	k ɯ tɕ a k ɯ tɕ a
ぐちゃぐちゃ	ɡ ɯ tɕ a ɡ ɯ tɕ a
くちゃり	k ɯ tɕ a ɾʲ i
ぐちゃり	ɡ ɯ tɕ a ɾʲ i
ぐちょぐちょ	ɡ ɯ tɕ o ɡ ɯ tɕ o
くっ	k ɯ ʔ
ぐっ	ɡ ɯ ʔ
くっきり	k ɯ c c i ɾʲ i
くっく	k ɯ k k ɯ
くっくっ	k ɯ k k ɯ ʔ
くつくつ	k ɯ ts ɯ k ɯ ts ɯ
ぐっぐっ	ɡ ɯ ɡ ɡ ɯ ʔ
ぐつぐつ	ɡ ɯ ts ɯ ɡ ɯ ts ɯ
ぐっさり	ɡ ɯ s s a ɾʲ i
ぐっしゃり	ɡ ɯ ɕ ɕ a ɾʲ i
ぐっしょり	ɡ ɯ ɕ ɕ o ɾʲ i
ぐっすり	ɡ ɯ s s ɯ ɾʲ i
ぐったり	ɡ ɯ t t a ɾʲ i
ぐでぐで	ɡ ɯ d e ɡ ɯ d e
ぐでんぐでん	ɡ ɯ d e ŋ ɡ ɯ d e ŋ
くどくど	k ɯ d o k ɯ d o
くにゃくにゃ	k ɯ ɲ a k ɯ ɲ a
ぐにゃぐにゃ	ɡ ɯ ɲ a ɡ ɯ ɲ a
ぐにゃり	ɡ ɯ ɲ a ɾʲ i
くねくね	k ɯ n e k ɯ n e
ぐびぐび	ɡ ɯ bʲ i ɡ ɯ bʲ i
ぐびり	ɡ ɯ bʲ i ɾʲ i
ぐびりぐびり	ɡ ɯ bʲ i ɾʲ i ɡ ɯ bʲ i ɾʲ i
くよくよ	k ɯ j o k ɯ j o
くらくら	k ɯ ɾ a k ɯ ɾ a
ぐらぐら	ɡ ɯ ɾ a ɡ ɯ ɾ a
くらっ	k ɯ ɾ a ʔ
ぐらっ	ɡ ɯ ɾ a ʔ
くらり	k ɯ ɾ a ɾʲ i
ぐらり	ɡ ɯ ɾ a ɾʲ i
ぐらりぐらり	ɡ ɯ ɾ a ɾʲ i ɡ ɯ ɾ a ɾʲ i
くりくり	k ɯ ɾʲ i k ɯ ɾʲ i
ぐりぐり	ɡ ɯ ɾʲ i ɡ ɯ ɾʲ i
くりっ	k ɯ ɾʲ i ʔ
くるくる	k ɯ ɾ ɯ k ɯ ɾ ɯ
ぐるぐる	ɡ ɯ ɾ ɯ ɡ ɯ ɾ ɯ
くるっ	k ɯ ɾ ɯ ʔ
ぐるっ	ɡ ɯ ɾ ɯ ʔ
くるり	k ɯ ɾ ɯ ɾʲ i
ぐるり	ɡ ɯ ɾ ɯ ɾʲ i
くるりくるり	k ɯ ɾ ɯ ɾʲ i k ɯ ɾ ɯ ɾʲ i
ぐるりぐるり	ɡ ɯ ɾ ɯ ɾʲ i ɡ ɯ ɾ ɯ ɾʲ i
ぐん	ɡ ɯ ɴ
くんくん	k ɯ ŋ k ɯ ɴ
ぐんぐん	ɡ ɯ ŋ ɡ ɯ ɴ
ぐんなり	ɡ ɯ n n a ɾʲ i
ぐんにゃり	ɡ ɯ ɲ ɲ a ɾʲ i
げー	ɡ eː
げーげー	ɡ eː ɡ eː
げーっ	ɡ eː ʔ
けざけざ	k e z a k e z a
けたけた	k e t a k e t a
げたげた	ɡ e t a ɡ e t a
けちょんけちょん	k e tɕ o ŋ k e tɕ o ɴ
げっそり	ɡ e s s o ɾʲ i
けばけば	k e b a k e b a
けらけら	k e ɾ a k e ɾ a
げらげら	ɡ e ɾ a ɡ e ɾ a
けろけろ	k e ɾ o k e ɾ o
げろげろ	ɡ e ɾ o ɡ e ɾ o
けろっ	k e ɾ o ʔ
けろり	k e ɾ o ɾʲ i
けんけん	k e ŋ k e ŋ
げんなり	ɡ e n n a ɾʲ i
ごーん	ɡ oː ɴ
こくこく	k o k ɯ k o k ɯ
ごくごく	ɡ o k ɯ ɡ o k ɯ
ごくっ	ɡ o k ɯ ʔ
こくり	k o k ɯ ɾʲ i
ごくり	ɡ o k ɯ ɾʲ i
こくりこくり	k o k ɯ ɾʲ i k o k ɯ ɾʲ i
ごくりごくり	ɡ o k ɯ ɾʲ i ɡ o k ɯ ɾʲ i
こくん	k o k ɯ ɴ
ごくん	ɡ o k ɯ ɴ
ごくんごくん	ɡ o k ɯ ŋ ɡ o k ɯ ɴ
こざっぱり	k o z a p p a ɾʲ i
ごしごし	ɡ o ɕ i ɡ o ɕ i
ごしゃごしゃ	ɡ o ɕ a ɡ o ɕ a
ごじゃごじゃ	ɡ o ʑ a ɡ o ʑ a
こせこせ	k o s e k o s e
こそ	k o s o
ごそ	ɡ o s o
こそこそ	k o s o k o s o
ごそごそ	ɡ o s o ɡ o s o
ごそっ	ɡ o s o ʔ
こそり	k o s o ɾʲ i
ごそり	ɡ o s o ɾʲ i
ごたごた	ɡ o t a ɡ o t a
こちこち	k o tɕ i k o tɕ i
ごちごち	ɡ o tɕ i ɡ o tɕ i
ごちゃごちゃ	ɡ o tɕ a ɡ o tɕ a
こちょこちょ	k o tɕ o k o tɕ o
ごちょごちょ	ɡ o tɕ o ɡ o tɕ o
こちり	k o tɕ i ɾʲ i
こちん	k o tɕ i ŋ
こちんこちん	k o tɕ i ŋ k o tɕ i ŋ
こぢんまり	k o ʑ i m m a ɾʲ i
ごつ	ɡ o ts ɯ
こっくり	k o k k ɯ ɾʲ i
ごっくり	ɡ o k k ɯ ɾʲ i
こつこつ	k o ts ɯ k o ts ɯ
ごつごつ	ɡ o ts ɯ ɡ o ts ɯ
こっそり	k o s s o ɾʲ i
ごっそり	ɡ o s s o ɾʲ i
こってり	k o t t e ɾʲ i
ごってり	ɡ o t t e ɾʲ i
ごっとり	ɡ o t t o ɾʲ i
こっとん	k o t t o ɴ
ごっとん	ɡ o t t o ɴ
こつん	k o ts ɯ ɴ
ごつん	ɡ o ts ɯ ɴ
こてこて	k o t e k o t e
ごてごて	ɡ o t e ɡ o t e
こてんこてん	k o t e ŋ k o t e ŋ
ことこと	k o t o k o t o
ごとごと	ɡ o t o ɡ o t o
ことり	k o t o ɾʲ i
ごとり	ɡ o t o ɾʲ i
ことん	k o t o ɴ
ごとん	ɡ o t o ɴ
ごにょごにょ	ɡ o ɲ o ɡ o ɲ o
ごほごほ	ɡ o h o ɡ o h o
ごぼごぼ	ɡ o b o ɡ o b o
ごぽごぽ	ɡ o p o ɡ o p o
ごほん	ɡ o h o ɴ
ごほんごほん	ɡ o h o ŋ ɡ o h o ɴ
こりこり	k o ɾʲ i k o ɾʲ i
ごりごり	ɡ o ɾʲ i ɡ o ɾʲ i
こりっ	k o ɾʲ i ʔ
ころころ	k o ɾ o k o ɾ o
ごろごろ	ɡ o ɾ o ɡ o ɾ o
ころっ	k o ɾ o ʔ
ごろっ	ɡ o ɾ o ʔ
ころり	k o ɾ o ɾʲ i
ごろり	ɡ o ɾ o ɾʲ i
ころりん	k o ɾ o ɾʲ i ŋ
ころりんしゃん	k o ɾ o ɾʲ i ɰ̃ ɕ a ɴ
ごろん	ɡ o ɾ o ɴ
ごわごわ	ɡ o w a ɡ o w a
こん	k o ɴ
ごん	ɡ o ɴ
こんがり	k o ŋ ɡ a ɾʲ i
こんこん	k o ŋ k o ɴ
ごんごん	ɡ o ŋ ɡ o ɴ
こんもり	k o m m o ɾʲ i
さーさー	s aː s aː
ざーざー	dz aː z aː
さーっ	s aː ʔ
ざーっ	dz aː ʔ
さくさく	s a k ɯ s a k ɯ
ざくざく	dz a k ɯ z a k ɯ
さくっ	s a k ɯ ʔ
ざくっ	dz a k ɯ ʔ
さくり	s a k ɯ ɾʲ i
ざくり	dz a k ɯ ɾʲ i
ざぐり	dz a ɡ ɯ ɾʲ i
さっ	s a ʔ
ざっ	dz a ʔ
ざっく	dz a k k ɯ
ざっくざっく	dz a k k ɯ z a k k ɯ
ざっくばらん	dz a k k ɯ b a ɾ a ɴ
さっくり	s a k k ɯ ɾʲ i
ざっくり	dz a k k ɯ ɾʲ i
さっさ	s a s s a
さっさっ	s a s s a ʔ
さっぱり	s a p p a ɾʲ i
さばさば	s a b a s a b a
ざぶ	dz a b ɯ
ざぶざぶ	dz a b ɯ z a b ɯ
ざぶり	dz a b ɯ ɾʲ i
ざぶん	dz a b ɯ ɴ
さめざめ	s a m e z a m e
さやさや	s a j a s a j a
さらさら	s a ɾ a s a ɾ a
ざらざら	dz a ɾ a z a ɾ a
さらっ	s a ɾ a ʔ
さらり	s a ɾ a ɾʲ i
ざらり	dz a ɾ a ɾʲ i
さわさわ	s a w a s a w a
ざわざわ	dz a w a z a w a
ざんざん	dz a n dz a ɴ
ざんぶ	dz a m b ɯ
ざんぶり	dz a m b ɯ ɾʲ i
じー	dʑ iː
じーじー	dʑ iː ʑ iː
じーっ	dʑ iː ʔ
しーん	ɕ iː ŋ
じーん	dʑ iː ŋ
しおしお	ɕ i o ɕ i o
しくしく	ɕ i k ɯ ɕ i k ɯ
じくじく	dʑ i k ɯ ʑ i k ɯ
しげしげ	ɕ i ɡ e ɕ i ɡ e
しこしこ	ɕ i k o ɕ i k o
しずしず	ɕ i z ɯ ɕ i z ɯ
じたばた	dʑ i t a b a t a
じっ	dʑ i ʔ
しっかり	ɕ i k k a ɾʲ i
しっくり	ɕ i k k ɯ ɾʲ i
じっくり	dʑ i k k ɯ ɾʲ i
しっとり	ɕ i t t o ɾʲ i
じっとり	dʑ i t t o ɾʲ i
しっぽり	ɕ i p p o ɾʲ i
しとしと	ɕ i t o ɕ i t o
じとじと	dʑ i t o ʑ i t o
しどろもどろ	ɕ i d o ɾ o m o d o ɾ o
しなしな	ɕ i n a ɕ i n a
しみじみ	ɕ i mʲ i ʑ i mʲ i
じめじめ	dʑ i m e ʑ i m e
しゃー	ɕ aː
じゃー	dʑ aː
しゃーしゃー	ɕ aː ɕ aː
じゃーじゃー	dʑ aː ʑ aː
しゃかしゃか	ɕ a k a ɕ a k a
じゃかじゃか	dʑ a k a ʑ a k a
じゃかすか	dʑ a k a s ɯ k a
しゃきしゃき	ɕ a c i ɕ a c i
しゃきっ	ɕ a c i ʔ
しゃっきり	ɕ a c c i ɾʲ i
しゃなりしゃなり	ɕ a n a ɾʲ i ɕ a n a ɾʲ i
しゃぶしゃぶ	ɕ a b ɯ ɕ a b ɯ
じゃぶじゃぶ	dʑ a b ɯ ʑ a b ɯ
じゃぼん	dʑ a b o ɴ
しゃらしゃら	ɕ a ɾ a ɕ a ɾ a
じゃらじゃら	dʑ a ɾ a ʑ a ɾ a
しゃりしゃり	ɕ a ɾʲ i ɕ a ɾʲ i
じゃりじゃり	dʑ a ɾʲ i ʑ a ɾʲ i
しゃりっ	ɕ a ɾʲ i ʔ
じゃりっ	dʑ a ɾʲ i ʔ
しゃん	ɕ a ɴ
じゃん	dʑ a ɴ
しゃんしゃん	ɕ a ɰ̃ ɕ a ɴ
じゃんじゃん	dʑ a n dʑ a ɴ
しゅー	ɕ ɯː
じゅー	dʑ ɯː
じゅーじゅー	dʑ ɯː ʑ ɯː
じゅくじゅく	dʑ ɯ k ɯ ʑ ɯ k ɯ
しゅっ	ɕ ɯ ʔ
じゅっ	dʑ ɯ ʔ
しゅっしゅっ	ɕ ɯ ɕ ɕ ɯ ʔ
しゅん	ɕ ɯ ɴ
しゅんしゅん	ɕ ɯ ɰ̃ ɕ ɯ ɴ
じょきじょき	dʑ o c i ʑ o c i
しょぼしょぼ	ɕ o b o ɕ o b o
しょぼん	ɕ o b o ɴ
しょりしょり	ɕ o ɾʲ i ɕ o ɾʲ i
じょりじょり	dʑ o ɾʲ i ʑ o ɾʲ i
しょんぼり	ɕ o m b o ɾʲ i
じりじり	dʑ i ɾʲ i ʑ i ɾʲ i
じろじろ	dʑ i ɾ o ʑ i ɾ o
じろっ	dʑ i ɾ o ʔ
じろり	dʑ i ɾ o ɾʲ i
じろりじろり	dʑ i ɾ o ɾʲ i ʑ i ɾ o ɾʲ i
しわくちゃ	ɕ i w a k ɯ tɕ a
しわしわ	ɕ i w a ɕ i w a
じわじわ	dʑ i w a ʑ i w a
じわっ	dʑ i w a ʔ
じわり	dʑ i w a ɾʲ i
しん	ɕ i ŋ
じん	dʑ i ŋ
じんじん	dʑ i n dʑ i ŋ
しんなり	ɕ i n n a ɾʲ i
しんねり	ɕ i n n e ɾʲ i
しんねりむっつり	ɕ i n n e ɾʲ i m ɯ t ts ɯ ɾʲ i
しんみり	ɕ i m mʲ i ɾʲ i
じんわり	dʑ i ɰ̃ w a ɾʲ i
すい	s ɯ i
ずい	dz ɯ i
すいすい	s ɯ i s ɯ i
ずいずい	dz ɯ i z ɯ i
すいっちょ	s ɯ i t tɕ o
ずー	dz ɯː
すーっ	s ɯː ʔ
ずーっ	dz ɯː ʔ
すかすか	s ɯ k a s ɯ k a
すがすが	s ɯ ɡ a s ɯ ɡ a
ずかずか	dz ɯ k a z ɯ k a
すかっ	s ɯ k a ʔ
ずきずき	dz ɯ c i z ɯ c i
すきっ	s ɯ c i ʔ
ずきん	dz ɯ c i ŋ
ずきんずきん	dz ɯ c i n dz ɯ c i ŋ
すくすく	s ɯ k ɯ s ɯ k ɯ
すけすけ	s ɯ k e s ɯ k e
ずけずけ	dz ɯ k e z ɯ k e
すこーん	s ɯ k oː ɴ
すごすご	s ɯ ɡ o s ɯ ɡ o
ずしずし	dz ɯ ɕ i z ɯ ɕ i
ずしり	dz ɯ ɕ i ɾʲ i
ずしん	dz ɯ ɕ i ŋ
すたこら	s ɯ t a k o ɾ a
すたすた	s ɯ t a s ɯ t a
ずたずた	dz ɯ t a z ɯ t a
ずだずだ	dz ɯ d a z ɯ d a
すっ	s ɯ ʔ
ずっ	dz ɯ ʔ
すっかり	s ɯ k k a ɾʲ i
すっきり	s ɯ c c i ɾʲ i
すっく	s ɯ k k ɯ
すっくり	s ɯ k k ɯ ɾʲ i
ずっしり	dz ɯ ɕ ɕ i ɾʲ i
すっすっ	s ɯ s s ɯ ʔ
すってん	s ɯ t t e ŋ
すってんころり	s ɯ t t e ŋ k o ɾ o ɾʲ i
すってんてん	s ɯ t t e n t e ŋ
すっぱすっぱ	s ɯ p p a s ɯ p p a
すっぱり	s ɯ p p a ɾʲ i
ずっぷり	dz ɯ p p ɯ ɾʲ i
すっぽり	s ɯ p p o ɾʲ i
すてん	s ɯ t e ŋ
ずでん	dz ɯ d e ŋ
すとん	s ɯ t o ɴ
ずどん	dz ɯ d o ɴ
すぱすぱ	s ɯ p a s ɯ p a
ずばずば	dz ɯ b a z ɯ b a
すぱっ	s ɯ p a ʔ
ずばっ	dz ɯ b a ʔ
すぱり	s ɯ p a ɾʲ i
ずばり	dz ɯ b a ɾʲ i
ずぶずぶ	dz ɯ b ɯ z ɯ b ɯ
ずぶり	dz ɯ b ɯ ɾʲ i
すべすべ	s ɯ b e s ɯ b e
すぽすぽ	s ɯ p o s ɯ p o
すぽっ	s ɯ p o ʔ
すぽり	s ɯ p o ɾʲ i
すぽん	s ɯ p o ɴ
ずぼん	dz ɯ b o ɴ
すやすや	s ɯ j a s ɯ j a
すらすら	s ɯ ɾ a s ɯ ɾ a
ずらずら	dz ɯ ɾ a z ɯ ɾ a
すらっ	s ɯ ɾ a ʔ
すらり	s ɯ ɾ a ɾʲ i
ずらり	dz ɯ ɾ a ɾʲ i
すらりすらり	s ɯ ɾ a ɾʲ i s ɯ ɾ a ɾʲ i
するする	s ɯ ɾ ɯ s ɯ ɾ ɯ
ずるずる	dz ɯ ɾ ɯ z ɯ ɾ ɯ
ずるずるべったり	dz ɯ ɾ ɯ z ɯ ɾ ɯ b e t t a ɾʲ i
するっ	s ɯ ɾ ɯ ʔ
ずるっ	dz ɯ ɾ ɯ ʔ
するり	s ɯ ɾ ɯ ɾʲ i
ずるり	dz ɯ ɾ ɯ ɾʲ i
ずるりずるり	dz ɯ ɾ ɯ ɾʲ i z ɯ ɾ ɯ ɾʲ i
ずん	dz ɯ ɴ
ずんぐり	dz ɯ ŋ ɡ ɯ ɾʲ i
ずんぐりむっくり	dz ɯ ŋ ɡ ɯ ɾʲ i m ɯ k k ɯ ɾʲ i
すんすん	s ɯ ɰ̃ s ɯ ɴ
ずんずん	dz ɯ n dz ɯ ɴ
すんなり	s ɯ n n a ɾʲ i
せかせか	s e k a s e k a
せっせ	s e s s e
ぞくぞく	dz o k ɯ z o k ɯ
ぞくっ	dz o k ɯ ʔ
そそくさ	s o s o k ɯ s a
そっ	s o ʔ
ぞっ	dz o ʔ
そっくり	s o k k ɯ ɾʲ i
そよ	s o j o
そよそよ	s o j o s o j o
そより	s o j o ɾʲ i
ぞりぞり	dz o ɾʲ i z o ɾʲ i
そろそろ	s o ɾ o s o ɾ o
ぞろぞろ	dz o ɾ o z o ɾ o
そろっ	s o ɾ o ʔ
ぞろっ	dz o ɾ o ʔ
そろり	s o ɾ o ɾʲ i
ぞろり	dz o ɾ o ɾʲ i
そろりそろり	s o ɾ o ɾʲ i s o ɾ o ɾʲ i
そわそわ	s o w a s o w a
だーん	d aː ɴ
だくだく	d a k ɯ d a k ɯ
たじたじ	t a ʑ i t a ʑ i
だっ	d a ʔ
たっぷり	t a p p ɯ ɾʲ i
たぷたぷ	t a p ɯ t a p ɯ
だぶだぶ	d a b ɯ d a b ɯ
だぼだぼ	d a b o d a b o
たらたら	t a ɾ a t a ɾ a
だらだら	d a ɾ a d a ɾ a
たらり	t a ɾ a ɾʲ i
だらり	d a ɾ a ɾʲ i
だらん	d a ɾ a ɴ
たんたん	t a n t a ɴ
たんまり	t a m m a ɾʲ i
ちーちー	tɕ iː tɕ iː
ちーん	tɕ iː ŋ
ちかちか	tɕ i k a tɕ i k a
ちかっ	tɕ i k a ʔ
ちくたく	tɕ i k ɯ t a k ɯ
ちくちく	tɕ i k ɯ tɕ i k ɯ
ちくっ	tɕ i k ɯ ʔ
ちぐはぐ	tɕ i ɡ ɯ h a ɡ ɯ
ちくり	tɕ i k ɯ ɾʲ i
ちちっかい	tɕ i tɕ i k k a i
ちっ	tɕ i ʔ
ちっくたっく	tɕ i k k ɯ t a k k ɯ
ちっちっ	tɕ i t tɕ i ʔ
ちびちび	tɕ i bʲ i tɕ i bʲ i
ちびりちびり	tɕ i bʲ i ɾʲ i tɕ i bʲ i ɾʲ i
ちまちま	tɕ i m a tɕ i m a
ちゃかちゃか	tɕ a k a tɕ a k a
ちゃきちゃき	tɕ a c i tɕ a c i
ちゃっかり	tɕ a k k a ɾʲ i
ちゃっぷちゃっぷ	tɕ a p p ɯ tɕ a p p ɯ
ちゃぶちゃぶ	tɕ a b ɯ tɕ a b ɯ
ちゃぷちゃぷ	tɕ a p ɯ tɕ a p ɯ
ちやほや	tɕ i j a h o j a
ちゃらちゃら	tɕ a ɾ a tɕ a ɾ a
ちゃりん	tɕ a ɾʲ i ŋ
ちゃん	tɕ a ɴ
ちゅー	tɕ ɯː
ちゅーちゅー	tɕ ɯː tɕ ɯː
ちゅちゅ	tɕ ɯ tɕ ɯ
ちゅっ	tɕ ɯ ʔ
ちゅんちゅん	tɕ ɯ n tɕ ɯ ɴ
ちょい	tɕ o i
ちょいちょい	tɕ o i tɕ o i
ちょきちょき	tɕ o c i tɕ o c i
ちょくちょく	tɕ o k ɯ tɕ o k ɯ
ちょこちょこ	tɕ o k o tɕ o k o
ちょこっ	tɕ o k o ʔ
ちょこなん	tɕ o k o n a ɴ
ちょこまか	tɕ o k o m a k a
ちょこん	tɕ o k o ɴ
ちょっきり	tɕ o c c i ɾʲ i
ちょっくら	tɕ o k k ɯ ɾ a
ちょっくらちょいと	tɕ o k k ɯ ɾ a tɕ o i t o
ちょっこり	tɕ o k k o ɾʲ i
ちょっぴり	tɕ o pʲ pʲ i ɾʲ i
ちょびちょび	tɕ o bʲ i tɕ o bʲ i
ちょびっ	tɕ o bʲ i ʔ
ちょぼちょぼ	tɕ o b o tɕ o b o
ちょろちょろ	tɕ o ɾ o tɕ o ɾ o
ちょろっ	tɕ o ɾ o ʔ
ちょろり	tɕ o ɾ o ɾʲ i
ちょん	tɕ o ɴ
ちょんちょん	tɕ o n tɕ o ɴ
ちらちら	tɕ i ɾ a tɕ i ɾ a
ちらっ	tɕ i ɾ a ʔ
ちらほら	tɕ i ɾ a h o ɾ a
ちらり	tɕ i ɾ a ɾʲ i
ちらりほらり	tɕ i ɾ a ɾʲ i h o ɾ a ɾʲ i
ちりちり	tɕ i ɾʲ i tɕ i ɾʲ i
ちりりん	tɕ i ɾʲ i ɾʲ i ŋ
ちりん	tɕ i ɾʲ i ŋ
ちりんちりん	tɕ i ɾʲ i n tɕ i ɾʲ i ŋ
ちろちろ	tɕ i ɾ o tɕ i ɾ o
ちろり	tɕ i ɾ o ɾʲ i
ちん	tɕ i ŋ
ちんとんしゃん	tɕ i n t o ɰ̃ ɕ a ɴ
ちんちろりん	tɕ i n tɕ i ɾ o ɾʲ i ŋ
ちんちん	tɕ i n tɕ i ŋ
ちんまり	tɕ i m m a ɾʲ i
つー	ts ɯː
つーっ	ts ɯː ʔ
つーつー	ts ɯː ts ɯː
つかつか	ts ɯ k a ts ɯ k a
つけつけ	ts ɯ k e ts ɯ k e
つつっ	ts ɯ ts ɯ ʔ
つづりさせ	ts ɯ z ɯ ɾʲ i s a s e
つべこべ	ts ɯ b e k o b e
つべつべ	ts ɯ b e ts ɯ b e
つべらこべら	ts ɯ b e ɾ a k o b e ɾ a
つやつや	ts ɯ j a ts ɯ j a
つるっ	ts ɯ ɾ ɯ ʔ
つるつる	ts ɯ ɾ ɯ ts ɯ ɾ ɯ
つるり	ts ɯ ɾ ɯ ɾʲ i
つるん	ts ɯ ɾ ɯ ɴ
つん	ts ɯ ɴ
つんけん	ts ɯ ŋ k e ŋ
つんつるてん	ts ɯ n ts ɯ ɾ ɯ t e ŋ
つんつん	ts ɯ n ts ɯ ɴ
てかてか	t e k a t e k a
でかでか	d e k a d e k a
てきぱき	t e c i p a c i
てくてく	t e k ɯ t e k ɯ
でくでく	d e k ɯ d e k ɯ
でこでこ	d e k o d e k o
でっぷり	d e p p ɯ ɾʲ i
てっぺんかけたか	t e p p e ŋ k a k e t a k a
でぶでぶ	d e b ɯ d e b ɯ
てらてら	t e ɾ a t e ɾ a
でれっ	d e ɾ e ʔ
てれつく	t e ɾ e ts ɯ k ɯ
でれでれ	d e ɾ e d e ɾ e
でれり	d e ɾ e ɾʲ i
でん	d e ŋ
てんてん	t e n t e ŋ
でんでん	d e n d e ŋ
とうてんこう	t o ɯ t e ŋ k o ɯ
どうどう	d o ɯ d o ɯ
どーん	d oː ɴ
どかっ	d o k a ʔ
どかどか	d o k a d o k a
どかん	d o k a ɴ
どきっ	d o c i ʔ
どきどき	d o c i d o c i
どぎまぎ	d o ɟ i m a ɟ i
どきり	d o c i ɾʲ i
どきん	d o c i ŋ
とくとく	t o k ɯ t o k ɯ
どくどく	d o k ɯ d o k ɯ
とげとげ	t o ɡ e t o ɡ e
とことこ	t o k o t o k o
どさっ	d o s a ʔ
どさどさ	d o s a d o s a
どさり	d o s a ɾʲ i
どさん	d o s a ɴ
どしどし	d o ɕ i d o ɕ i
どしん	d o ɕ i ŋ
どすどす	d o s ɯ d o s ɯ
どすん	d o s ɯ ɴ
どすんどすん	d o s ɯ n d o s ɯ ɴ
どたっ	d o t a ʔ
どたどた	d o t a d o t a
どたばた	d o t a b a t a
どたり	d o t a ɾʲ i
どたりばたり	d o t a ɾʲ i b a t a ɾʲ i
どたん	d o t a ɴ
どたんばたん	d o t a m b a t a ɴ
どっ	d o ʔ
どっか	d o k k a
どっかり	d o k k a ɾʲ i
どっきり	d o c c i ɾʲ i
とっくり	t o k k ɯ ɾʲ i
どっさり	d o s s a ɾʲ i
どっしり	d o ɕ ɕ i ɾʲ i
とっと	t o t t o
とっぷり	t o p p ɯ ɾʲ i
どっぷり	d o p p ɯ ɾʲ i
どてっ	d o t e ʔ
どてん	d o t e ŋ
どどん	d o d o ɴ
どぶどぶ	d o b ɯ d o b ɯ
どぶり	d o b ɯ ɾʲ i
どぶん	d o b ɯ ɴ
どやどや	d o j a d o j a
とろっ	t o ɾ o ʔ
どろっ	d o ɾ o ʔ
とろとろ	t o ɾ o t o ɾ o
どろどろ	d o ɾ o d o ɾ o
とろり	t o ɾ o ɾʲ i
どろり	d o ɾ o ɾʲ i
とろん	t o ɾ o ɴ
どろん	d o ɾ o ɴ
とん	t o ɴ
どん	d o ɴ
どんちゃん	d o n tɕ a ɴ
とんちんかん	t o n tɕ i ŋ k a ɴ
とんとん	t o n t o ɴ
どんどん	d o n d o ɴ
どんぴしゃり	d o m pʲ i ɕ a ɾʲ i
どんより	d o ɰ̃ j o ɾʲ i
なみなみ	n a mʲ i n a mʲ i
なよなよ	n a j o n a j o
にーっ	ɲ iː ʔ
にこ	ɲ i k o
にこっ	ɲ i k o ʔ
にこにこ	ɲ i k o ɲ i k o
にこり	ɲ i k o ɾʲ i
にたにた	ɲ i t a ɲ i t a
にたり	ɲ i t a ɾʲ i
にちゃにちゃ	ɲ i tɕ a ɲ i tɕ a
にっ	ɲ i ʔ
にっこ	ɲ i k k o
にっこり	ɲ i k k o ɾʲ i
にゃーにゃー	ɲ aː ɲ aː
にやにや	ɲ i j a ɲ i j a
にやり	ɲ i j a ɾʲ i
にやりにやり	ɲ i j a ɾʲ i ɲ i j a ɾʲ i
にゃんにゃん	ɲ a ɲ ɲ a ɴ
にゅー	ɲ ɯː
にゅっ	ɲ ɯ ʔ
にょきっ	ɲ o c i ʔ
にょきにょき	ɲ o c i ɲ o c i
にょっきり	ɲ o c c i ɾʲ i
にょろにょろ	ɲ o ɾ o ɲ o ɾ o
にょろり	ɲ o ɾ o ɾʲ i
にんまり	ɲ i m m a ɾʲ i
ぬくぬく	n ɯ k ɯ n ɯ k ɯ
ぬけぬけ	n ɯ k e n ɯ k e
ぬっ	n ɯ ʔ
ぬっく	n ɯ k k ɯ
ぬっぺり	n ɯ p p e ɾʲ i
ぬめっ	n ɯ m e ʔ
ぬめぬめ	n ɯ m e n ɯ m e
ぬらぬら	n ɯ ɾ a n ɯ ɾ a
ぬらり	n ɯ ɾ a ɾʲ i
ぬらりくらり	n ɯ ɾ a ɾʲ i k ɯ ɾ a ɾʲ i
ぬるっ	n ɯ ɾ ɯ ʔ
ぬるぬる	n ɯ ɾ ɯ n ɯ ɾ ɯ
ぬるり	n ɯ ɾ ɯ ɾʲ i
ねちねち	n e tɕ i n e tɕ i
ねっちり	n e t tɕ i ɾʲ i
ねっとり	n e t t o ɾʲ i
ねとねと	n e t o n e t o
ねばねば	n e b a n e b a
のこのこ	n o k o n o k o
のそのそ	n o s o n o s o
のそり	n o s o ɾʲ i
のそりのそり	n o s o ɾʲ i n o s o ɾʲ i
のたり	n o t a ɾʲ i
のたりのたり	n o t a ɾʲ i n o t a ɾʲ i
のっ	n o ʔ
のっしのっし	n o ɕ ɕ i n o ɕ ɕ i
のっそり	n o s s o ɾʲ i
のったり	n o t t a ɾʲ i
のっぺり	n o p p e ɾʲ i
のびのび	n o bʲ i n o bʲ i
のほほん	n o h o h o ɴ
のらくら	n o ɾ a k ɯ ɾ a
のらりくらり	n o ɾ a ɾʲ i k ɯ ɾ a ɾʲ i
のろくさ	n o ɾ o k ɯ s a
のろのろ	n o ɾ o n o ɾ o
のろり	n o ɾ o ɾʲ i
のろりのろり	n o ɾ o ɾʲ i n o ɾ o ɾʲ i
のんびり	n o m bʲ i ɾʲ i
ぱーっ	p aː ʔ
はーはー	h aː h aː
ぱーぱー	p aː p aː
ばーん	b aː ɴ
ぱーん	p aː ɴ
はいはい	h a i h a i
ばかすか	b a k a s ɯ k a
ぱかっ	p a k a ʔ
ぱかぱか	p a k a p a k a
はきはき	h a c i h a c i
ばきばき	b a c i b a c i
ぱきぱき	p a c i p a c i
はくしょん	h a k ɯ ɕ o ɴ
ぱくっ	p a k ɯ ʔ
ぱくぱく	p a k ɯ p a k ɯ
ぱくり	p a k ɯ ɾʲ i
ばさっ	b a s a ʔ
ばさばさ	b a s a b a s a
ぱさぱさ	p a s a p a s a
ばさり	b a s a ɾʲ i
ぱさり	p a s a ɾʲ i
ばしっ	b a ɕ i ʔ
ばしゃばしゃ	b a ɕ a b a ɕ a
ぱしゃぱしゃ	p a ɕ a p a ɕ a
はた	h a t a
ばたっ	b a t a ʔ
ぱたっ	p a t a ʔ
はたはた	h a t a h a t a
ばたばた	b a t a b a t a
ぱたぱた	p a t a p a t a
はたり	h a t a ɾʲ i
ばたり	b a t a ɾʲ i
ぱたり	p a t a ɾʲ i
ばたん	b a t a ɴ
ぱたん	p a t a ɴ
ぱちくり	p a tɕ i k ɯ ɾʲ i
ぱちっ	p a tɕ i ʔ
ばちばち	b a tɕ i b a tɕ i
ぱちぱち	p a tɕ i p a tɕ i
ばちゃばちゃ	b a tɕ a b a tɕ a
ぱちり	p a tɕ i ɾʲ i
ぱちん	p a tɕ i ŋ
はっ	h a ʔ
ばっ	b a ʔ
ぱっ	p a ʔ
はっきり	h a c c i ɾʲ i
ぱっくり	p a k k ɯ ɾʲ i
ばっさり	b a s s a ɾʲ i
はっし	h a ɕ ɕ i
はった	h a t t a
ばったばった	b a t t a b a t t a
ばったり	b a t t a ɾʲ i
ぱったり	p a t t a ɾʲ i
ばっちり	b a t tɕ i ɾʲ i
ぱっちり	p a t tɕ i ɾʲ i
ぱっぱ	p a p p a
はっはっ	h a h h a ʔ
ぱっぱっ	p a p p a ʔ
ばてばて	b a t e b a t e
ぱぱっ	p a p a ʔ
ばらっ	b a ɾ a ʔ
ぱらっ	p a ɾ a ʔ
はらはら	h a ɾ a h a ɾ a
ばらばら	b a ɾ a b a ɾ a
ぱらぱら	p a ɾ a p a ɾ a
はらり	h a ɾ a ɾʲ i
ばらり	b a ɾ a ɾʲ i
ぱらり	p a ɾ a ɾʲ i
はらりはらり	h a ɾ a ɾʲ i h a ɾ a ɾʲ i
ばらんばらん	b a ɾ a m b a ɾ a ɴ
ばりっ	b a ɾʲ i ʔ
ぱりっ	p a ɾʲ i ʔ
ばりばり	b a ɾʲ i b a ɾʲ i
ぱりぱり	p a ɾʲ i p a ɾʲ i
ぱん	p a ɴ
ばんばん	b a m b a ɴ
ぱんぱん	p a m p a ɴ
ひー	ç iː
びー	bʲ iː
ぴーちくぱーちく	pʲ iː tɕ i k ɯ p aː tɕ i k ɯ
ひーひー	ç iː ç iː
びーびー	bʲ iː bʲ iː
ぴーぴー	pʲ iː pʲ iː
ぴーん	pʲ iː ŋ
ぴかっ	pʲ i k a ʔ
ひかひか	ç i k a ç i k a
ぴかぴか	pʲ i k a pʲ i k a
ぴかり	pʲ i k a ɾʲ i
びくっ	bʲ i k ɯ ʔ
ぴくっ	pʲ i k ɯ ʔ
ひくひく	ç i k ɯ ç i k ɯ
びくびく	bʲ i k ɯ bʲ i k ɯ
ぴくぴく	pʲ i k ɯ pʲ i k ɯ
びくり	bʲ i k ɯ ɾʲ i
ぴくり	pʲ i k ɯ ɾʲ i
ぴくん	pʲ i k ɯ ɴ
びしっ	bʲ i ɕ i ʔ
ぴしっ	pʲ i ɕ i ʔ
ひしひし	ç i ɕ i ç i ɕ i
びしびし	bʲ i ɕ i bʲ i ɕ i
ぴしぴし	pʲ i ɕ i pʲ i ɕ i
ぴしゃっ	pʲ i ɕ a ʔ
びしゃびしゃ	bʲ i ɕ a bʲ i ɕ a
ぴしゃぴしゃ	pʲ i ɕ a pʲ i ɕ a
びしゃり	bʲ i ɕ a ɾʲ i
ぴしゃり	pʲ i ɕ a ɾʲ i
ぴしゃん	pʲ i ɕ a ɴ
びしょびしょ	bʲ i ɕ o bʲ i ɕ o
びしり	bʲ i ɕ i ɾʲ i
ぴしり	pʲ i ɕ i ɾʲ i
ひそひそ	ç i s o ç i s o
ぴたっ	pʲ i t a ʔ
ひたひた	ç i t a ç i t a
びたびた	bʲ i t a bʲ i t a
ぴたぴた	pʲ i t a pʲ i t a
ぴたり	pʲ i t a ɾʲ i
びちびち	bʲ i tɕ i bʲ i tɕ i
ぴちぴち	pʲ i tɕ i pʲ i tɕ i
びちゃびちゃ	bʲ i tɕ a bʲ i tɕ a
ぴちゃぴちゃ	pʲ i tɕ a pʲ i tɕ a
ぴちゃり	pʲ i tɕ a ɾʲ i
ぴちゃん	pʲ i tɕ a ɴ
びちょびちょ	bʲ i tɕ o bʲ i tɕ o
ぴちり	pʲ i tɕ i ɾʲ i
ぴちん	pʲ i tɕ i ŋ
びっ	bʲ i ʔ
ぴっかぴか	pʲ i k k a pʲ i k a
ひっかり	ç i k k a ɾʲ i
びっくり	bʲ i k k ɯ ɾʲ i
びっしょり	bʲ i ɕ ɕ o ɾʲ i
びっしり	bʲ i ɕ ɕ i ɾʲ i
ひっそり	ç i s s o ɾʲ i
ひっそりかん	ç i s s o ɾʲ i k a ɴ
びったり	bʲ i t t a ɾʲ i
ぴっちり	pʲ i t tɕ i ɾʲ i
ひひ	ç i ç i
ひひん	ç i ç i ŋ
ひやっ	ç i j a ʔ
ひやひや	ç i j a ç i j a
ひやり	ç i j a ɾʲ i
ひゅー	ç ɯː
びゅー	bʲ ɯː
ぴゅー	pʲ ɯː
ひゅーどろどろ	ç ɯː d o ɾ o d o ɾ o
ひゅーひゅー	ç ɯː ç ɯː
びゅーびゅー	bʲ ɯː bʲ ɯː
ぴゅーぴゅー	pʲ ɯː pʲ ɯː
ひゅっ	ç ɯ ʔ
びゅっ	bʲ ɯ ʔ
ぴゅっ	pʲ ɯ ʔ
びゅんびゅん	bʲ ɯ m bʲ ɯ ɴ
ひょい	ç o i
ひょいひょい	ç o i ç o i
ぴょいぴょい	pʲ o i pʲ o i
ひょこひょこ	ç o k o ç o k o
ぴょこぴょこ	pʲ o k o pʲ o k o
ひょこり	ç o k o ɾʲ i
ぴょこり	pʲ o k o ɾʲ i
ひょっ	ç o ʔ
ひょっくり	ç o k k ɯ ɾʲ i
ひょっこり	ç o k k o ɾʲ i
ぴょっこり	pʲ o k k o ɾʲ i
ひよひよ	ç i j o ç i j o
ぴよぴよ	pʲ i j o pʲ i j o
ひょろっ	ç o ɾ o ʔ
ひょろひょろ	ç o ɾ o ç o ɾ o
ひょろり	ç o ɾ o ɾʲ i
ぴょん	pʲ o ɴ
ぴょんぴょん	pʲ o m pʲ o ɴ
ひらひら	ç i ɾ a ç i ɾ a
びらびら	bʲ i ɾ a bʲ i ɾ a
ぴらぴら	pʲ i ɾ a pʲ i ɾ a
ひらり	ç i ɾ a ɾʲ i
ひらりひらり	ç i ɾ a ɾʲ i ç i ɾ a ɾʲ i
ひりっ	ç i ɾʲ i ʔ
びりっ	bʲ i ɾʲ i ʔ
ぴりっ	pʲ i ɾʲ i ʔ
ひりひり	ç i ɾʲ i ç i ɾʲ i
びりびり	bʲ i ɾʲ i bʲ i ɾʲ i
ぴりぴり	pʲ i ɾʲ i pʲ i ɾʲ i
ひりり	ç i ɾʲ i ɾʲ i
びりり	bʲ i ɾʲ i ɾʲ i
ぴりり	pʲ i ɾʲ i ɾʲ i
ひん	ç i ŋ
ぴん	pʲ i ŋ
ぴんしゃん	pʲ i ɰ̃ ɕ a ɴ
ひんひん	ç i ɰ̃ ç i ŋ
びんびん	bʲ i m bʲ i ŋ
ぴんぴん	pʲ i m pʲ i ŋ
ぴんぽん	pʲ i m p o ɴ
ひんやり	ç i ɰ̃ j a ɾʲ i
ぷい	p ɯ i
ふー	ɸ ɯː
ぶー	b ɯː
ぷー	p ɯː
ふーっ	ɸ ɯː ʔ
ふーふー	ɸ ɯː ɸ ɯː
ぶうぶう	b ɯː b ɯː
ぷーぷー	p ɯː p ɯː
ぷーん	p ɯː ɴ
ふかふか	ɸ ɯ k a ɸ ɯ k a
ふがふが	ɸ ɯ ɡ a ɸ ɯ ɡ a
ぶかぶか	b ɯ k a b ɯ k a
ぷかぷか	p ɯ k a p ɯ k a
ぷかりぷかり	p ɯ k a ɾʲ i p ɯ k a ɾʲ i
ぷくっ	p ɯ k ɯ ʔ
ふくふく	ɸ ɯ k ɯ ɸ ɯ k ɯ
ぶくぶく	b ɯ k ɯ b ɯ k ɯ
ぷくぷく	p ɯ k ɯ p ɯ k ɯ
ふさふさ	ɸ ɯ s a ɸ ɯ s a
ぶすっ	b ɯ s ɯ ʔ
ぶすぶす	b ɯ s ɯ b ɯ s ɯ
ぷすぷす	p ɯ s ɯ p ɯ s ɯ
ぶすり	b ɯ s ɯ ɾʲ i
ぷすり	p ɯ s ɯ ɾʲ i
ぷちぷち	p ɯ tɕ i p ɯ tɕ i
ふっ	ɸ ɯ ʔ
ぶっ	b ɯ ʔ
ぷっ	p ɯ ʔ
ふっくら	ɸ ɯ k k ɯ ɾ a
ふっくり	ɸ ɯ k k ɯ ɾʲ i
ぷっくり	p ɯ k k ɯ ɾʲ i
ぷつっ	p ɯ ts ɯ ʔ
ふっつり	ɸ ɯ t ts ɯ ɾʲ i
ぶっつり	b ɯ t ts ɯ ɾʲ i
ぷっつり	p ɯ t ts ɯ ɾʲ i
ぷっつん	p ɯ t ts ɯ ɴ
ふつふつ	ɸ ɯ ts ɯ ɸ ɯ ts ɯ
ぶつぶつ	b ɯ ts ɯ b ɯ ts ɯ
ぷつぷつ	p ɯ ts ɯ p ɯ ts ɯ
ぷっぷっ	p ɯ p p ɯ ʔ
ふつり	ɸ ɯ ts ɯ ɾʲ i
ぶつり	b ɯ ts ɯ ɾʲ i
ぷつり	p ɯ ts ɯ ɾʲ i
ぷつん	p ɯ ts ɯ ɴ
ふにゃふにゃ	ɸ ɯ ɲ a ɸ ɯ ɲ a
ふふん	ɸ ɯ ɸ ɯ ɴ
ぶよぶよ	b ɯ j o b ɯ j o
ふらふら	ɸ ɯ ɾ a ɸ ɯ ɾ a
ぶらぶら	b ɯ ɾ a b ɯ ɾ a
ぷらぷら	p ɯ ɾ a p ɯ ɾ a
ふらり	ɸ ɯ ɾ a ɾʲ i
ぶらり	b ɯ ɾ a ɾʲ i
ふらりふらり	ɸ ɯ ɾ a ɾʲ i ɸ ɯ ɾ a ɾʲ i
ぶらりぶらり	b ɯ ɾ a ɾʲ i b ɯ ɾ a ɾʲ i
ぶらん	b ɯ ɾ a ɴ
ぷらん	p ɯ ɾ a ɴ
ぶりぶり	b ɯ ɾʲ i b ɯ ɾʲ i
ぷりぷり	p ɯ ɾʲ i p ɯ ɾʲ i
ぶるっ	b ɯ ɾ ɯ ʔ
ぶるぶる	b ɯ ɾ ɯ b ɯ ɾ ɯ
ぶるん	b ɯ ɾ ɯ ɴ
ぶるんぶるん	b ɯ ɾ ɯ m b ɯ ɾ ɯ ɴ
ふわ	ɸ ɯ w a
ふわっ	ɸ ɯ w a ʔ
ふわふわ	ɸ ɯ w a ɸ ɯ w a
ぶわぶわ	b ɯ w a b ɯ w a
ふわり	ɸ ɯ w a ɾʲ i
ふん	ɸ ɯ ɴ
ぷん	p ɯ ɴ
ふんふん	ɸ ɯ ɰ̃ ɸ ɯ ɴ
ぶんぶん	b ɯ m b ɯ ɴ
ぷんぷん	p ɯ m p ɯ ɴ
ふんわり	ɸ ɯ ɰ̃ w a ɾʲ i
へこへこ	h e k o h e k o
べこべこ	b e k o b e k o
ぺこぺこ	p e k o p e k o
ぺこり	p e k o ɾʲ i
ぺこん	p e k o ɴ
ぺしゃんこ	p e ɕ a ŋ k o
べたっ	b e t a ʔ
ぺたっ	p e t a ʔ
へたへた	h e t a h e t a
べたべた	b e t a b e t a
ぺたぺた	p e t a p e t a
べたり	b e t a ɾʲ i
ぺたり	p e t a ɾʲ i
ぺたん	p e t a ɴ
べちゃくちゃ	b e tɕ a k ɯ tɕ a
ぺちゃくちゃ	p e tɕ a k ɯ tɕ a
べちゃべちゃ	b e tɕ a b e tɕ a
ぺちゃぺちゃ	p e tɕ a p e tɕ a
ぺちゃん	p e tɕ a ɴ
ぺちゃんこ	p e tɕ a ŋ k o
ぺっ	p e ʔ
べったり	b e t t a ɾʲ i
ぺったり	p e t t a ɾʲ i
ぺったんこ	p e t t a ŋ k o
ぺっちゃんこ	p e t tɕ a ŋ k o
べっとり	b e t t o ɾʲ i
ぺっぺっ	p e p p e ʔ
へとへと	h e t o h e t o
べとべと	b e t o b e t o
へどもど	h e d o m o d o
へなへな	h e n a h e n a
へらへら	h e ɾ a h e ɾ a
べらべら	b e ɾ a b e ɾ a
ぺらぺら	p e ɾ a p e ɾ a
べりべり	b e ɾʲ i b e ɾʲ i
ぺろっ	p e ɾ o ʔ
へろへろ	h e ɾ o h e ɾ o
べろべろ	b e ɾ o b e ɾ o
ぺろぺろ	p e ɾ o p e ɾ o
べろり	b e ɾ o ɾʲ i
ぺろり	p e ɾ o ɾʲ i
べろんべろん	b e ɾ o m b e ɾ o ɴ
ぺんぺん	p e m p e ŋ
ぽい	p o i
ほいほい	h o i h o i
ぽいぽい	p o i p o i
ぼいん	b o i ŋ
ぽかーん	p o k aː ɴ
ぼかすか	b o k a s ɯ k a
ぽかっ	p o k a ʔ
ほかほか	h o k a h o k a
ぼかぼか	b o k a b o k a
ぽかぽか	p o k a p o k a
ぽかり	p o k a ɾʲ i
ぽかりぽかり	p o k a ɾʲ i p o k a ɾʲ i
ぽかん	p o k a ɴ
ぽきっ	p o c i ʔ
ぼきぼき	b o c i b o c i
ぽきぽき	p o c i p o c i
ほぎゃー	h o ɟ aː
ぼきり	b o c i ɾʲ i
ぽきり	p o c i ɾʲ i
ほくほく	h o k ɯ h o k ɯ
ぼくぼく	b o k ɯ b o k ɯ
ぽくぽく	p o k ɯ p o k ɯ
ぼけっ	b o k e ʔ
ぽけっ	p o k e ʔ
ぼこぼこ	b o k o b o k o
ぽこぽこ	p o k o p o k o
ぽこん	p o k o ɴ
ぽこんぽこん	p o k o m p o k o ɴ
ぼさっ	b o s a ʔ
ぼさぼさ	b o s a b o s a
ぼじゃぼじゃ	b o ʑ a b o ʑ a
ぼそっ	b o s o ʔ
ぼそぼそ	b o s o b o s o
ぼそり	b o s o ɾʲ i
ほぞんかけたか	h o z o ŋ k a k e t a k a
ぼたぼた	b o t a b o t a
ぽたぽた	p o t a p o t a
ぼたり	b o t a ɾʲ i
ぽたり	p o t a ɾʲ i
ぼたりぼたり	b o t a ɾʲ i b o t a ɾʲ i
ぽたりぽたり	p o t a ɾʲ i p o t a ɾʲ i
ぽちっ	p o tɕ i ʔ
ぼちぼち	b o tɕ i b o tɕ i
ぽちぽち	p o tɕ i p o tɕ i
ぼちゃぼちゃ	b o tɕ a b o tɕ a
ぽちゃぽちゃ	p o tɕ a p o tɕ a
ぼちゃん	b o tɕ a ɴ
ぽちゃん	p o tɕ a ɴ
ほっ	h o ʔ
ぼっ	b o ʔ
ぽっ	p o ʔ
ほっかり	h o k k a ɾʲ i
ぼっかり	b o k k a ɾʲ i
ぽっかり	p o k k a ɾʲ i
ぽっきり	p o c c i ɾʲ i
ぽっくり	p o k k ɯ ɾʲ i
ぽっこり	p o k k o ɾʲ i
ほっそり	h o s s o ɾʲ i
ぼったり	b o t t a ɾʲ i
ぽっちゃり	p o t tɕ a ɾʲ i
ほっちり	h o t tɕ i ɾʲ i
ぽっちり	p o t tɕ i ɾʲ i
ぽっつり	p o t ts ɯ ɾʲ i
ぼってり	b o t t e ɾʲ i
ぽってり	p o t t e ɾʲ i
ぽっぽ	p o p p o
ぼつぼつ	b o ts ɯ b o ts ɯ
ぽつぽつ	p o ts ɯ p o ts ɯ
ぽっぽっ	p o p p o ʔ
ぽつり	p o ts ɯ ɾʲ i
ぽつりぽつり	p o ts ɯ ɾʲ i p o ts ɯ ɾʲ i
ぽつん	p o ts ɯ ɴ
ぼてぼて	b o t e b o t e
ぽてぽて	p o t e p o t e
ぼとぼと	b o t o b o t o
ぽとぽと	p o t o p o t o
ぼとり	b o t o ɾʲ i
ぽとり	p o t o ɾʲ i
ほのぼの	h o n o b o n o
ほほ	h o h o
ほほう	h o h o ɯ
ぼやっ	b o j a ʔ
ほやほや	h o j a h o j a
ぼやぼや	b o j a b o j a
ぽやぽや	p o j a p o j a
ぼりぼり	b o ɾʲ i b o ɾʲ i
ぽりぽり	p o ɾʲ i p o ɾʲ i
ほろ	h o ɾ o
ほろっ	h o ɾ o ʔ
ぽろっ	p o ɾ o ʔ
ほろほろ	h o ɾ o h o ɾ o
ぼろぼろ	b o ɾ o b o ɾ o
ぽろぽろ	p o ɾ o p o ɾ o
ほろり	h o ɾ o ɾʲ i
ぼろり	b o ɾ o ɾʲ i
ぽろり	p o ɾ o ɾʲ i
ほろろ	h o ɾ o ɾ o
ぼろん	b o ɾ o ɴ
ぼん	b o ɴ
ぽん	p o ɴ
ほんのり	h o n n o ɾʲ i
ぽんぽこ	p o m p o k o
ぼんぼん	b o m b o ɴ
ぽんぽん	p o m p o ɴ
ぼんやり	b o ɰ̃ j a ɾʲ i
ほんわか	h o ɰ̃ w a k a
まごまご	m a ɡ o m a ɡ o
まざまざ	m a z a m a z a
まじまじ	m a ʑ i m a ʑ i
まったり	m a t t a ɾʲ i
まんじり	m a n dʑ i ɾʲ i
みしみし	mʲ i ɕ i mʲ i ɕ i
みすみす	mʲ i s ɯ mʲ i s ɯ
みっしり	mʲ i ɕ ɕ i ɾʲ i
みっちり	mʲ i t tɕ i ɾʲ i
みりみり	mʲ i ɾʲ i mʲ i ɾʲ i
みんみん	mʲ i m mʲ i ŋ
むかっ	m ɯ k a ʔ
むかむか	m ɯ k a m ɯ k a
むくっ	m ɯ k ɯ ʔ
むくむく	m ɯ k ɯ m ɯ k ɯ
むくり	m ɯ k ɯ ɾʲ i
むくりむくり	m ɯ k ɯ ɾʲ i m ɯ k ɯ ɾʲ i
むざむざ	m ɯ z a m ɯ z a
むしゃくしゃ	m ɯ ɕ a k ɯ ɕ a
むしゃむしゃ	m ɯ ɕ a m ɯ ɕ a
むず	m ɯ z ɯ
むすっ	m ɯ s ɯ ʔ
むずむず	m ɯ z ɯ m ɯ z ɯ
むちむち	m ɯ tɕ i m ɯ tɕ i
むちゃくちゃ	m ɯ tɕ a k ɯ tɕ a
むっ	m ɯ ʔ
むっく	m ɯ k k ɯ
むっくり	m ɯ k k ɯ ɾʲ i
むっちり	m ɯ t tɕ i ɾʲ i
むっつり	m ɯ t ts ɯ ɾʲ i
むにゃむにゃ	m ɯ ɲ a m ɯ ɲ a
むらむら	m ɯ ɾ a m ɯ ɾ a
むんず	m ɯ n dz ɯ
むんむ	m ɯ m m ɯ
むんむん	m ɯ m m ɯ ɴ
めきめき	m e c i m e c i
めそめそ	m e s o m e s o
めためた	m e t a m e t a
めちゃくちゃ	m e tɕ a k ɯ tɕ a
めちゃめちゃ	m e tɕ a m e tɕ a
めっきり	m e c c i ɾʲ i
めらめら	m e ɾ a m e ɾ a
めりめり	m e ɾʲ i m e ɾʲ i
めろめろ	m e ɾ o m e ɾ o
もうもう	m o ɯ m o ɯ
もがもが	m o ɡ a m o ɡ a
もくもく	m o k ɯ m o k ɯ
もぐもぐ	m o ɡ ɯ m o ɡ ɯ
もこもこ	m o k o m o k o
もごもご	m o ɡ o m o ɡ o
もさっ	m o s a ʔ
もさもさ	m o s a m o s a
もじもじ	m o ʑ i m o ʑ i
もしゃもしゃ	m o ɕ a m o ɕ a
もじゃもじゃ	m o ʑ a m o ʑ a
もそもそ	m o s o m o s o
もぞもぞ	m o z o m o z o
もたもた	m o t a m o t a
もちもち	m o tɕ i m o tɕ i
もっさり	m o s s a ɾʲ i
もやもや	m o j a m o j a
もりもり	m o ɾʲ i m o ɾʲ i
もわっ	m o w a ʔ
やきもき	j a c i m o c i
やきやき	j a c i j a c i
やすやす	j a s ɯ j a s ɯ
やっさもっさ	j a s s a m o s s a
やわやわ	j a w a j a w a
やんわり	j a ɰ̃ w a ɾʲ i
ゆさゆさ	j ɯ s a j ɯ s a
ゆっくり	j ɯ k k ɯ ɾʲ i
ゆっさり	j ɯ s s a ɾʲ i
ゆったり	j ɯ t t a ɾʲ i
ゆぶゆぶ	j ɯ b ɯ j ɯ b ɯ
ゆらゆら	j ɯ ɾ a j ɯ ɾ a
ゆらり	j ɯ ɾ a ɾʲ i
ゆらりゆらり	j ɯ ɾ a ɾʲ i j ɯ ɾ a ɾʲ i
ゆるゆる	j ɯ ɾ ɯ j ɯ ɾ ɯ
ゆるり	j ɯ ɾ ɯ ɾʲ i
よたよた	j o t a j o t a
よちよち	j o tɕ i j o tɕ i
よぼよぼ	j o b o j o b o
よれよれ	j o ɾ e j o ɾ e
よろよろ	j o ɾ o j o ɾ o
よろり	j o ɾ o ɾʲ i
りーん	ɾʲ iː ŋ
りん	ɾʲ i ŋ
りんりん	ɾʲ i n ɾʲ i ŋ
るんるん	ɾ ɯ n ɾ ɯ ɴ
れろれろ	ɾ e ɾ o ɾ e ɾ o
わー	w aː
わーっ	w aː ʔ
わーわー	w aː w aː
わいわい	w a i w a i
わくわく	w a k ɯ w a k ɯ
わさわさ	w a s a w a s a
わっ	w a ʔ
わっさわっさ	w a s s a w a s s a
わなわな	w a n a w a n a
わはは	w a h a h a
わん	w a ɴ
わんさ	w a ɰ̃ s a
わんさか	w a ɰ̃ s a k a
わんさわんさ	w a ɰ̃ s a w a ɰ̃ s a
わんわん	w a ɰ̃ w a ɴ
だず	d a z ɯ
ぬっ	n ɯ ʔ
ぐー	ɡ ɯː
ぽん	p o ɴ
すっ	s ɯ ʔ
がっ	ɡ a ʔ
ぽ	p o
ぎ	ɟ i
かい	k a i
ぶゆ	b ɯ j ɯ
きっ	c i ʔ
ちゃ	tɕ a
すき	s ɯ c i
ち	tɕ i
でれ	d e ɾ e
かすか	k a s ɯ k a
きら	c i ɾ a
む	m ɯ
きろ	c i ɾ o
ばらん	b a ɾ a ɴ
させ	s a s e
ぼっ	b o ʔ
す	s ɯ
にゃー	ɲ aː
ぼく	b o k ɯ
ぼろ	b o ɾ o
かな	k a n a
け	k e
こ	k o
きざ	c i z a
ぽこ	p o k o
しり	ɕ i ɾʲ i
ばか	b a k a
たっ	t a ʔ
ばった	b a t t a
さり	s a ɾʲ i
う	ɯ
し	ɕ i
ちゃぷ	tɕ a p ɯ
てれ	t e ɾ e
こち	k o tɕ i
に	ɲ i
とう	t o ɯ
ちゃり	tɕ a ɾʲ i
っとり	t t o ɾʲ i
らかん	ɾ a k a ɴ
つづり	ts ɯ z ɯ ɾʲ i
ひっ	ç i ʔ
でく	d e k ɯ
ぽや	p o j a
もう	m o ɯ
ぞ	dz o
ほ	h o
はー	h aː
そり	s o ɾʲ i
ざけざ	dz a k e z a
ぴー	pʲ iː
ゃ	aː
やわ	j a w a
お	o
さ	s a
うざ	ɯ z a
ぐり	ɡ ɯ ɾʲ i
すっぱ	s ɯ p p a
つ	ts ɯ
びっ	bʲ i ʔ
くら	k ɯ ɾ a
ほぞ	h o z o
がた	ɡ a t a
ざー	dz aː
つく	ts ɯ k ɯ
っ	ʔ
しん	ɕ i ŋ
でこ	d e k o
おい	o i
ぐ	ɡ ɯ
ず	dz ɯ
ほろ	h o ɾ o
ちょっくら	tɕ o k k ɯ ɾ a
さー	s aː
ぴ	pʲ i
ちゅ	tɕ ɯ
ほっ	h o ʔ
あぶ	a b ɯ
ちんとん	tɕ i n t o ɴ
あん	a ɴ
てっぺん	t e p p e ŋ
しゃん	ɕ a ɴ
くり	k ɯ ɾʲ i
げ	ɡ e
じ	dʑ i
どぶ	d o b ɯ
でん	d e ŋ
あざ	a z a
べら	b e ɾ a
うる	ɯ ɾ ɯ
ゅ	ɯː
どう	d o ɯ
と	t o
てんこう	t e ŋ k o ɯ
ちく	tɕ i k ɯ
よ	j o
むん	m ɯ ɴ
きん	c i ŋ
こぎこ	k o ɟ i k o
ぴち	pʲ i tɕ i
ば	b a
ひ	ç i
よろ	j o ɾ o
より	j o ɾʲ i
び	bʲ i
ろ	ɾ o
ふ	ɸ ɯ
ちり	tɕ i ɾʲ i
いけ	i k e
ちちっ	tɕ i tɕ i ʔ
べつ	b e ts ɯ
にー	ɲ iː
とっ	t o ʔ
かけた	k a k e t a
ぷかり	p ɯ k a ɾʲ i
ぶ	b ɯ
はい	h a i
ゆっ	j ɯ ʔ
ちゃっぷ	tɕ a p p ɯ
き	c i
そ	s o
ちょ	tɕ o
ぴょい	pʲ o i
しょ	ɕ o
ぼけ	b o k e
あけ	a k e
だ	d a
ひか	ç i k a
ちっ	tɕ i ʔ
ゆ	j ɯ
のろ	n o ɾ o
ずる	dz ɯ ɾ ɯ
ぶっ	b ɯ ʔ
ぶちゃ	b ɯ tɕ a
ぼかす	b o k a s ɯ
ご	ɡ o
ぺり	p e ɾʲ i
ぎゃー	ɟ aː
り	ɾʲ i
こーん	k oː ɴ
たり	t a ɾʲ i
ぼ	b o
で	d e
かり	k a ɾʲ i
でぶ	d e b ɯ
こっ	k o ʔ
べ	b e
ぽご	p o ɡ o
ざ	dz a
い	i
らん	ɾ a ɴ
ん	ɴ
ねり	n e ɾʲ i
ずし	dz ɯ ɕ i
ごちょご	ɡ o tɕ o ɡ o
びち	bʲ i tɕ i
ごち	ɡ o tɕ i
じゃ	dʑ a
ちょいと	tɕ o i t o
しゃり	ɕ a ɾʲ i
ちっく	tɕ i k k ɯ
ぱ	p a
く	k ɯ
のろく	n o ɾ o k ɯ
すん	s ɯ ɴ
のっ	n o ʔ
つり	ts ɯ ɾʲ i
もが	m o ɡ a
がっぽ	ɡ a p p o
て	t e
びり	bʲ i ɾʲ i
か	k a
