가닐가닐	k ɐ n i ɭ k ɐ n i ɭ
가닥가닥	k ɐ t ɐ k k͈ ɐ t ɐ k
가동가동	k ɐ t o ŋ k ɐ t o ŋ
가둥가둥	k ɐ t u ŋ k ɐ t u ŋ
가드락가드락	k ɐ t ɨ ɭ ɐ k k͈ ɐ t ɨ ɭ ɐ k
가득	k ɐ t ɨ k
가득가득	k ɐ t ɨ k k͈ ɐ t ɨ k
가든가든	k ɐ t ɨ n k ɐ t ɨ n
가들막가들막	k ɐ t ɨ ɭ m ɐ k k͈ ɐ t ɨ ɭ m ɐ k
가뜩	k ɐ t͈ ɨ k
가뜩가뜩	k ɐ t͈ ɨ k k͈ ɐ t͈ ɨ k
가뜬가뜬	k ɐ t͈ ɨ n k ɐ t͈ ɨ n
가랑가랑	k ɐ ɭ ɐ ŋ k ɐ ɭ ɐ ŋ
가르랑	k ɐ ɭ ɨ ɭ ɐ ŋ
가르랑가르랑	k ɐ ɭ ɨ ɭ ɐ ŋ k ɐ ɭ ɨ ɭ ɐ ŋ
가리가리	k ɐ ɭ i k ɐ ɭ i
가물가물	k ɐ m u ɭ k ɐ m u ɭ
가뭇가뭇	k ɐ m u t k͈ ɐ m u t
가분가분	k ɐ p u n k ɐ p u n
가불가불	k ɐ p u ɭ k ɐ p u ɭ
가붓가붓	k ɐ p u t k͈ ɐ p u t
가뿐가뿐	k ɐ p͈ u n k ɐ p͈ u n
가뿟가뿟	k ɐ p͈ u t k͈ ɐ p͈ u t
가슬가슬	k ɐ s ɨ ɭ k ɐ s ɨ ɭ
가슴츠레	k ɐ s ɨ m tɕʰ ɨ ɭ e
가치작가치작	k ɐ tɕʰ i tɕ ɐ k k͈ ɐ tɕʰ i tɕ ɐ k
가칠가칠	k ɐ tɕʰ i ɭ k ɐ tɕʰ i ɭ
가칫가칫	k ɐ tɕʰ i t k͈ ɐ tɕʰ i t
가탈가탈	k ɐ tʰ ɐ ɭ k ɐ tʰ ɐ ɭ
간닥간닥	k ɐ n t ɐ k k͈ ɐ n t ɐ k
간당간당	k ɐ n t ɐ ŋ k ɐ n t ɐ ŋ
간댕간댕	k ɐ n t ɛ ŋ k ɐ n t ɛ ŋ
간동간동	k ɐ n t o ŋ k ɐ n t o ŋ
간드랑간드랑	k ɐ n t ɨ ɭ ɐ ŋ k ɐ n t ɨ ɭ ɐ ŋ
간드작간드작	k ɐ n t ɨ tɕ ɐ k k͈ ɐ n t ɨ tɕ ɐ k
간들간들	k ɐ n t ɨ ɭ k ɐ n t ɨ ɭ
간실간실	k ɐ n s i ɭ k ɐ n s i ɭ
간종간종	k ɐ n tɕ o ŋ k ɐ n tɕ o ŋ
간질간질	k ɐ n tɕ i ɭ k ɐ n tɕ i ɭ
갈갈	k ɐ ɭ k ɐ ɭ
갈그락	k ɐ ɭ k ɨ ɭ ɐ k
갈그락갈그락	k ɐ ɭ k ɨ ɭ ɐ k k͈ ɐ ɭ k ɨ ɭ ɐ k
갈그랑갈그랑	k ɐ ɭ k ɨ ɭ ɐ ŋ k ɐ ɭ k ɨ ɭ ɐ ŋ
갈근갈근	k ɐ ɭ k ɨ n k ɐ ɭ k ɨ n
갈기갈기	k ɐ ɭ k i k ɐ ɭ k i
갈래갈래	k ɐ ɭ ɭ ɛ k ɐ ɭ ɭ ɛ
갈쌍	k ɐ ɭ s͈ ɐ ŋ
갈쌍갈쌍	k ɐ ɭ s͈ ɐ ŋ k ɐ ɭ s͈ ɐ ŋ
갈씬갈씬	k ɐ ɭ s͈ i n k ɐ ɭ s͈ i n
갈팡질팡	k ɐ ɭ pʰ ɐ ŋ tɕ i ɭ pʰ ɐ ŋ
갉작갉작	k ɐ k tɕ͈ ɐ k k͈ ɐ k tɕ͈ ɐ k
갉죽갉죽	k ɐ k tɕ͈ u k k͈ ɐ k tɕ͈ u k
감감	k ɐ m k ɐ m
감숭감숭	k ɐ m s u ŋ k ɐ m s u ŋ
감실감실	k ɐ m s i ɭ k ɐ m s i ɭ
감작감작	k ɐ m tɕ ɐ k k͈ ɐ m tɕ ɐ k
강동	k ɐ ŋ t o ŋ
강동강동	k ɐ ŋ t o ŋ k ɐ ŋ t o ŋ
강장	k ɐ ŋ tɕ ɐ ŋ
강장강장	k ɐ ŋ tɕ ɐ ŋ k ɐ ŋ tɕ ɐ ŋ
강중	k ɐ ŋ tɕ u ŋ
강중강중	k ɐ ŋ tɕ u ŋ k ɐ ŋ tɕ u ŋ
개골개골	k ɛ k o ɭ k ɛ k o ɭ
개굴개굴	k ɛ k u ɭ k ɛ k u ɭ
개신개신	k ɛ s i n k ɛ s i n
개웃	k ɛ u t
개을리	k ɛ ɨ ɭ ɭ i
개코쥐코	k ɛ kʰ o tɕ w i kʰ o
갭직갭직	k ɛ p tɕ͈ i k k͈ ɛ p tɕ͈ i k
갸름갸름	k j ɐ ɭ ɨ m k j ɐ ɭ ɨ m
갸릉갸릉	k j ɐ ɭ ɨ ŋ k j ɐ ɭ ɨ ŋ
갸우뚱	k j ɐ u t͈ u ŋ
갸우뚱갸우뚱	k j ɐ u t͈ u ŋ k j ɐ u t͈ u ŋ
갸웃	k j ɐ u t
갸웃갸웃	k j ɐ u t k͈ j ɐ u t
걀걀	k j ɐ ɭ k j ɐ ɭ
걀쭉걀쭉	k j ɐ ɭ tɕ͈ u k k͈ j ɐ ɭ tɕ͈ u k
걀쯤걀쯤	k j ɐ ɭ tɕ͈ ɨ m k j ɐ ɭ tɕ͈ ɨ m
걀찍걀찍	k j ɐ ɭ tɕ͈ i k k͈ j ɐ ɭ tɕ͈ i k
거덕거덕	k ʌ t ʌ k k͈ ʌ t ʌ k
거덜거덜	k ʌ t ʌ ɭ k ʌ t ʌ ɭ
거둠거둠	k ʌ t u m k ʌ t u m
거드럭거드럭	k ʌ t ɨ ɭ ʌ k k͈ ʌ t ɨ ɭ ʌ k
거든거든	k ʌ t ɨ n k ʌ t ɨ n
거들먹거들먹	k ʌ t ɨ ɭ m ʌ k k͈ ʌ t ɨ ɭ m ʌ k
거듬거듬	k ʌ t ɨ m k ʌ t ɨ m
거뜬거뜬	k ʌ t͈ ɨ n k ʌ t͈ ɨ n
거물거물	k ʌ m u ɭ k ʌ m u ɭ
거뭇거뭇	k ʌ m u t k͈ ʌ m u t
거분거분	k ʌ p u n k ʌ p u n
거불거불	k ʌ p u ɭ k ʌ p u ɭ
거붓거붓	k ʌ p u t k͈ ʌ p u t
거뿐거뿐	k ʌ p͈ u n k ʌ p͈ u n
거뿟거뿟	k ʌ p͈ u t k͈ ʌ p͈ u t
거슬거슬	k ʌ s ɨ ɭ k ʌ s ɨ ɭ
거슴츠레	k ʌ s ɨ m tɕʰ ɨ ɭ e
거춤거춤	k ʌ tɕʰ u m k ʌ tɕʰ u m
거충거충	k ʌ tɕʰ u ŋ k ʌ tɕʰ u ŋ
거치적거치적	k ʌ tɕʰ i tɕ ʌ k k͈ ʌ tɕʰ i tɕ ʌ k
거칠거칠	k ʌ tɕʰ i ɭ k ʌ tɕʰ i ɭ
거칫거칫	k ʌ tɕʰ i t k͈ ʌ tɕʰ i t
거푼거푼	k ʌ pʰ u n k ʌ pʰ u n
거풀거풀	k ʌ pʰ u ɭ k ʌ pʰ u ɭ
거풋거풋	k ʌ pʰ u t k͈ ʌ pʰ u t
걱실걱실	k ʌ k s͈ i ɭ k ʌ k s͈ i ɭ
건덩건덩	k ʌ n t ʌ ŋ k ʌ n t ʌ ŋ
건둥건둥	k ʌ n t u ŋ k ʌ n t u ŋ
건둥반둥	k ʌ n t u ŋ p ɐ n t u ŋ
건득건득	k ʌ n t ɨ k k͈ ʌ n t ɨ k
건들	k ʌ n t ɨ ɭ
건들건들	k ʌ n t ɨ ɭ k ʌ n t ɨ ɭ
건듯	k ʌ n t ɨ t
건듯건듯	k ʌ n t ɨ t k͈ ʌ n t ɨ t
건뜻	k ʌ n t͈ ɨ t
건뜻건뜻	k ʌ n t͈ ɨ t k͈ ʌ n t͈ ɨ t
건성건성	k ʌ n s ʌ ŋ k ʌ n s ʌ ŋ
건정건정	k ʌ n tɕ ʌ ŋ k ʌ n tɕ ʌ ŋ
건중건중	k ʌ n tɕ u ŋ k ʌ n tɕ u ŋ
걸걸	k ʌ ɭ k ʌ ɭ
걸근걸근	k ʌ ɭ k ɨ n k ʌ ɭ k ɨ n
걸씬걸씬	k ʌ ɭ s͈ i n k ʌ ɭ s͈ i n
걸쩍걸쩍	k ʌ ɭ tɕ͈ ʌ k k͈ ʌ ɭ tɕ͈ ʌ k
걸핏	k ʌ ɭ pʰ i t
걸핏걸핏	k ʌ ɭ pʰ i t k͈ ʌ ɭ pʰ i t
검불덤불	k ʌ m p u ɭ t ʌ m p u ɭ
검숭검숭	k ʌ m s u ŋ k ʌ m s u ŋ
검실검실	k ʌ m s i ɭ k ʌ m s i ɭ
검적검적	k ʌ m tɕ ʌ k k͈ ʌ m tɕ ʌ k
겅둥	k ʌ ŋ t u ŋ
겅둥겅둥	k ʌ ŋ t u ŋ k ʌ ŋ t u ŋ
겅성드뭇	k ʌ ŋ s ʌ ŋ t ɨ m u t
겅정	k ʌ ŋ tɕ ʌ ŋ
겅정겅정	k ʌ ŋ tɕ ʌ ŋ k ʌ ŋ tɕ ʌ ŋ
겅중	k ʌ ŋ tɕ u ŋ
겅중겅중	k ʌ ŋ tɕ u ŋ k ʌ ŋ tɕ u ŋ
게걸게걸	k e k ʌ ɭ k e k ʌ ɭ
게게	k e k e
게두덜게두덜	k e t u t ʌ ɭ k e t u t ʌ ɭ
게슴츠레	k e s ɨ m tɕʰ ɨ ɭ e
게을리	k e ɨ ɭ ɭ i
게정게정	k e tɕ ʌ ŋ k e tɕ ʌ ŋ
겯거니틀거니	k j ʌ t k͈ ʌ n i tʰ ɨ ɭ k ʌ n i
고기작고기작	k o k i tɕ ɐ k k͈ o k i tɕ ɐ k
고깃고깃	k o k i t k͈ o k i t
고독고독	k o t o k k͈ o t o k
고들고들	k o t ɨ ɭ k o t ɨ ɭ
고래고래	k o ɭ ɛ k o ɭ ɛ
고로롱고로롱	k o ɭ o ɭ o ŋ k o ɭ o ɭ o ŋ
고리	k o ɭ i
고리조리	k o ɭ i tɕ o ɭ i
고무락고무락	k o m u ɭ ɐ k k͈ o m u ɭ ɐ k
고물고물	k o m u ɭ k o m u ɭ
고부랑고부랑	k o p u ɭ ɐ ŋ k o p u ɭ ɐ ŋ
고부장고부장	k o p u tɕ ɐ ŋ k o p u tɕ ɐ ŋ
고분고분	k o p u n k o p u n
고불고불	k o p u ɭ k o p u ɭ
고불탕고불탕	k o p u ɭ tʰ ɐ ŋ k o p u ɭ tʰ ɐ ŋ
고붓고붓	k o p u t k͈ o p u t
고상고상	k o s ɐ ŋ k o s ɐ ŋ
고슬고슬	k o s ɨ ɭ k o s ɨ ɭ
고시랑고시랑	k o s i ɭ ɐ ŋ k o s i ɭ ɐ ŋ
고실고실	k o s i ɭ k o s i ɭ
고질고질	k o tɕ i ɭ k o tɕ i ɭ
곤드레	k o n t ɨ ɭ e
곤드레만드레	k o n t ɨ ɭ e m ɐ n t ɨ ɭ e
골골	k o ɭ k o ɭ
골막골막	k o ɭ m ɐ k k͈ o ɭ m ɐ k
골싹골싹	k o ɭ s͈ ɐ k k͈ o ɭ s͈ ɐ k
곰곰	k o m k o m
곰상곰상	k o m s ɐ ŋ k o m s ɐ ŋ
곰실곰실	k o m s i ɭ k o m s i ɭ
곰작	k o m tɕ ɐ k
곰작곰작	k o m tɕ ɐ k k͈ o m tɕ ɐ k
곰지락	k o m tɕ i ɭ ɐ k
곰지락곰지락	k o m tɕ i ɭ ɐ k k͈ o m tɕ i ɭ ɐ k
곰틀	k o m tʰ ɨ ɭ
곰틀곰틀	k o m tʰ ɨ ɭ k o m tʰ ɨ ɭ
곱슬곱슬	k o p s͈ ɨ ɭ k o p s͈ ɨ ɭ
곱실	k o p s͈ i ɭ
곱실곱실	k o p s͈ i ɭ k o p s͈ i ɭ
곱이곱이	k o p i k o p i
곱작	k o p tɕ͈ ɐ k
곱작곱작	k o p tɕ͈ ɐ k k͈ o p tɕ͈ ɐ k
공닥공닥	k o ŋ t ɐ k k͈ o ŋ t ɐ k
광광	k w ɐ ŋ k w ɐ ŋ
구구	k u k u
구기적구기적	k u k i tɕ ʌ k k͈ u k i tɕ ʌ k
구깃구깃	k u k i t k͈ u k i t
구덕구덕	k u t ʌ k k͈ u t ʌ k
구두덜구두덜	k u t u t ʌ ɭ k u t u t ʌ ɭ
구둑구둑	k u t u k k͈ u t u k
구들구들	k u t ɨ ɭ k u t ɨ ɭ
구무럭구무럭	k u m u ɭ ʌ k k͈ u m u ɭ ʌ k
구물구물	k u m u ɭ k u m u ɭ
구부렁구부렁	k u p u ɭ ʌ ŋ k u p u ɭ ʌ ŋ
구부정구부정	k u p u tɕ ʌ ŋ k u p u tɕ ʌ ŋ
구불구불	k u p u ɭ k u p u ɭ
구불텅구불텅	k u p u ɭ tʰ ʌ ŋ k u p u ɭ tʰ ʌ ŋ
구붓구붓	k u p u t k͈ u p u t
구슬구슬	k u s ɨ ɭ k u s ɨ ɭ
구시렁구시렁	k u s i ɭ ʌ ŋ k u s i ɭ ʌ ŋ
구질구질	k u tɕ i ɭ k u tɕ i ɭ
군실군실	k u n s i ɭ k u n s i ɭ
굴먹굴먹	k u ɭ m ʌ k k͈ u ɭ m ʌ k
굴썩굴썩	k u ɭ s͈ ʌ k k͈ u ɭ s͈ ʌ k
굼실굼실	k u m s i ɭ k u m s i ɭ
굼적	k u m tɕ ʌ k
굼적굼적	k u m tɕ ʌ k k͈ u m tɕ ʌ k
굼지럭	k u m tɕ i ɭ ʌ k
굼지럭굼지럭	k u m tɕ i ɭ ʌ k k͈ u m tɕ i ɭ ʌ k
굼틀	k u m tʰ ɨ ɭ
굼틀굼틀	k u m tʰ ɨ ɭ k u m tʰ ɨ ɭ
굽슬굽슬	k u p s͈ ɨ ɭ k u p s͈ ɨ ɭ
굽신	k u p s͈ i n
굽신굽신	k u p s͈ i n k u p s͈ i n
굽실	k u p s͈ i ɭ
굽실굽실	k u p s͈ i ɭ k u p s͈ i ɭ
굽적	k u p tɕ͈ ʌ k
굽적굽적	k u p tɕ͈ ʌ k k͈ u p tɕ͈ ʌ k
궁싯궁싯	k u ŋ s i t k͈ u ŋ s i t
귀둥대둥	k w i t u ŋ t ɛ t u ŋ
귀뚤귀뚤	k w i t͈ u ɭ k w i t͈ u ɭ
그닐그닐	k ɨ n i ɭ k ɨ n i ɭ
그득	k ɨ t ɨ k
그득그득	k ɨ t ɨ k k͈ ɨ t ɨ k
그들먹그들먹	k ɨ t ɨ ɭ m ʌ k k͈ ɨ t ɨ ɭ m ʌ k
그뜩	k ɨ t͈ ɨ k
그뜩그뜩	k ɨ t͈ ɨ k k͈ ɨ t͈ ɨ k
그러구러	k ɨ ɭ ʌ k u ɭ ʌ
그러루	k ɨ ɭ ʌ ɭ u
그러저러	k ɨ ɭ ʌ tɕ ʌ ɭ ʌ
그렁그렁	k ɨ ɭ ʌ ŋ k ɨ ɭ ʌ ŋ
그르렁	k ɨ ɭ ɨ ɭ ʌ ŋ
그르렁그르렁	k ɨ ɭ ɨ ɭ ʌ ŋ k ɨ ɭ ɨ ɭ ʌ ŋ
그리	k ɨ ɭ i
그리저리	k ɨ ɭ i tɕ ʌ ɭ i
그물그물	k ɨ m u ɭ k ɨ m u ɭ
근덕근덕	k ɨ n t ʌ k k͈ ɨ n t ʌ k
근뎅근뎅	k ɨ n t e ŋ k ɨ n t e ŋ
근드렁근드렁	k ɨ n t ɨ ɭ ʌ ŋ k ɨ n t ɨ ɭ ʌ ŋ
근드적근드적	k ɨ n t ɨ tɕ ʌ k k͈ ɨ n t ɨ tɕ ʌ k
근들근들	k ɨ n t ɨ ɭ k ɨ n t ɨ ɭ
근실근실	k ɨ n s i ɭ k ɨ n s i ɭ
근질근질	k ɨ n tɕ i ɭ k ɨ n tɕ i ɭ
글그렁글그렁	k ɨ ɭ k ɨ ɭ ʌ ŋ k ɨ ɭ k ɨ ɭ ʌ ŋ
글썽	k ɨ ɭ s͈ ʌ ŋ
글썽글썽	k ɨ ɭ s͈ ʌ ŋ k ɨ ɭ s͈ ʌ ŋ
글컹글컹	k ɨ ɭ kʰ ʌ ŋ k ɨ ɭ kʰ ʌ ŋ
긁적긁적	k ɨ k tɕ͈ ʌ k k͈ ɨ k tɕ͈ ʌ k
긁죽긁죽	k ɨ k tɕ͈ u k k͈ ɨ k tɕ͈ u k
금실금실	k ɨ m s i ɭ k ɨ m s i ɭ
기럭기럭	k i ɭ ʌ k k͈ i ɭ ʌ k
기름기름	k i ɭ ɨ m k i ɭ ɨ m
기신기신	k i s i n k i s i n
기엄기엄	k i ʌ m k i ʌ m
기엄둥실	k i ʌ m t u ŋ s i ɭ
기우뚱	k i u t͈ u ŋ
기우뚱기우뚱	k i u t͈ u ŋ k i u t͈ u ŋ
기웃	k i u t
기웃기웃	k i u t k͈ i u t
긴가민가	k i n k ɐ m i n k ɐ
길쑴길쑴	k i ɭ s͈ u m k i ɭ s͈ u m
길쭉길쭉	k i ɭ tɕ͈ u k k͈ i ɭ tɕ͈ u k
길쯤길쯤	k i ɭ tɕ͈ ɨ m k i ɭ tɕ͈ ɨ m
길찍길찍	k i ɭ tɕ͈ i k k͈ i ɭ tɕ͈ i k
까강까강	k͈ ɐ k ɐ ŋ k͈ ɐ k ɐ ŋ
까끌까끌	k͈ ɐ k͈ ɨ ɭ k͈ ɐ k͈ ɨ ɭ
까닥	k͈ ɐ t ɐ k
까닥까닥	k͈ ɐ t ɐ k k͈ ɐ t ɐ k
까드락까드락	k͈ ɐ t ɨ ɭ ɐ k k͈ ɐ t ɨ ɭ ɐ k
까들막까들막	k͈ ɐ t ɨ ɭ m ɐ k k͈ ɐ t ɨ ɭ m ɐ k
까딱	k͈ ɐ t͈ ɐ k
까딱까딱	k͈ ɐ t͈ ɐ k k͈ ɐ t͈ ɐ k
까뜨락까뜨락	k͈ ɐ t͈ ɨ ɭ ɐ k k͈ ɐ t͈ ɨ ɭ ɐ k
까랑까랑	k͈ ɐ ɭ ɐ ŋ k͈ ɐ ɭ ɐ ŋ
까르르	k͈ ɐ ɭ ɨ ɭ ɨ
까르르까르르	k͈ ɐ ɭ ɨ ɭ ɨ k͈ ɐ ɭ ɨ ɭ ɨ
까르륵	k͈ ɐ ɭ ɨ ɭ ɨ k
까르륵까르륵	k͈ ɐ ɭ ɨ ɭ ɨ k k͈ ɐ ɭ ɨ ɭ ɨ k
까막까막	k͈ ɐ m ɐ k k͈ ɐ m ɐ k
까무룩	k͈ ɐ m u ɭ u k
까물까물	k͈ ɐ m u ɭ k͈ ɐ m u ɭ
까뭇까뭇	k͈ ɐ m u t k͈ ɐ m u t
까불까불	k͈ ɐ p u ɭ k͈ ɐ p u ɭ
까스스	k͈ ɐ s ɨ s ɨ
까슬까슬	k͈ ɐ s ɨ ɭ k͈ ɐ s ɨ ɭ
까옥	k͈ ɐ o k
까옥까옥	k͈ ɐ o k k͈ ɐ o k
까치작까치작	k͈ ɐ tɕʰ i tɕ ɐ k k͈ ɐ tɕʰ i tɕ ɐ k
까칠까칠	k͈ ɐ tɕʰ i ɭ k͈ ɐ tɕʰ i ɭ
까칫까칫	k͈ ɐ tɕʰ i t k͈ ɐ tɕʰ i t
깍	k͈ ɐ k
깍깍	k͈ ɐ k k͈ ɐ k
깍둑깍둑	k͈ ɐ k t͈ u k k͈ ɐ k t͈ u k
깐닥깐닥	k͈ ɐ n t ɐ k k͈ ɐ n t ɐ k
깐동깐동	k͈ ɐ n t o ŋ k͈ ɐ n t o ŋ
깐딱	k͈ ɐ n t͈ ɐ k
깐딱깐딱	k͈ ɐ n t͈ ɐ k k͈ ɐ n t͈ ɐ k
깐실깐실	k͈ ɐ n s i ɭ k͈ ɐ n s i ɭ
깐작깐작	k͈ ɐ n tɕ ɐ k k͈ ɐ n tɕ ɐ k
깐족깐족	k͈ ɐ n tɕ o k k͈ ɐ n tɕ o k
깐죽깐죽	k͈ ɐ n tɕ u k k͈ ɐ n tɕ u k
깐질깐질	k͈ ɐ n tɕ i ɭ k͈ ɐ n tɕ i ɭ
깔깔	k͈ ɐ ɭ k͈ ɐ ɭ
깔끔깔끔	k͈ ɐ ɭ k͈ ɨ m k͈ ɐ ɭ k͈ ɨ m
깔딱	k͈ ɐ ɭ t͈ ɐ k
깔딱깔딱	k͈ ɐ ɭ t͈ ɐ k k͈ ɐ ɭ t͈ ɐ k
깔짝깔짝	k͈ ɐ ɭ tɕ͈ ɐ k k͈ ɐ ɭ tɕ͈ ɐ k
깔쭉깔쭉	k͈ ɐ ɭ tɕ͈ u k k͈ ɐ ɭ tɕ͈ u k
깜깜	k͈ ɐ m k͈ ɐ m
깜박	k͈ ɐ m p ɐ k
깜박깜박	k͈ ɐ m p ɐ k k͈ ɐ m p ɐ k
깜빡	k͈ ɐ m p͈ ɐ k
깜빡깜빡	k͈ ɐ m p͈ ɐ k k͈ ɐ m p͈ ɐ k
깜작	k͈ ɐ m tɕ ɐ k
깜작깜작	k͈ ɐ m tɕ ɐ k k͈ ɐ m tɕ ɐ k
깜짝	k͈ ɐ m tɕ͈ ɐ k
깜짝깜짝	k͈ ɐ m tɕ͈ ɐ k k͈ ɐ m tɕ͈ ɐ k
깝신깝신	k͈ ɐ p s͈ i n k͈ ɐ p s͈ i n
깝작깝작	k͈ ɐ p tɕ͈ ɐ k k͈ ɐ p tɕ͈ ɐ k
깝죽깝죽	k͈ ɐ p tɕ͈ u k k͈ ɐ p tɕ͈ u k
깟깟	k͈ ɐ t k͈ ɐ t
깡깡	k͈ ɐ ŋ k͈ ɐ ŋ
깡동	k͈ ɐ ŋ t o ŋ
깡동깡동	k͈ ɐ ŋ t o ŋ k͈ ɐ ŋ t o ŋ
깡둥	k͈ ɐ ŋ t u ŋ
깡둥깡둥	k͈ ɐ ŋ t u ŋ k͈ ɐ ŋ t u ŋ
깡똥	k͈ ɐ ŋ t͈ o ŋ
깡똥깡똥	k͈ ɐ ŋ t͈ o ŋ k͈ ɐ ŋ t͈ o ŋ
깡짱	k͈ ɐ ŋ tɕ͈ ɐ ŋ
깡짱깡짱	k͈ ɐ ŋ tɕ͈ ɐ ŋ k͈ ɐ ŋ tɕ͈ ɐ ŋ
깡쭝	k͈ ɐ ŋ tɕ͈ u ŋ
깡쭝깡쭝	k͈ ɐ ŋ tɕ͈ u ŋ k͈ ɐ ŋ tɕ͈ u ŋ
깡창	k͈ ɐ ŋ tɕʰ ɐ ŋ
깡창깡창	k͈ ɐ ŋ tɕʰ ɐ ŋ k͈ ɐ ŋ tɕʰ ɐ ŋ
깡충	k͈ ɐ ŋ tɕʰ u ŋ
깡충깡충	k͈ ɐ ŋ tɕʰ u ŋ k͈ ɐ ŋ tɕʰ u ŋ
깨개갱	k͈ ɛ k ɛ k ɛ ŋ
깨갱	k͈ ɛ k ɛ ŋ
깨갱깨갱	k͈ ɛ k ɛ ŋ k͈ ɛ k ɛ ŋ
깨깨	k͈ ɛ k͈ ɛ
깨드득	k͈ ɛ t ɨ t ɨ k
깨웃	k͈ ɛ u t
깨웃깨웃	k͈ ɛ u t k͈ ɛ u t
깨작깨작	k͈ ɛ tɕ ɐ k k͈ ɛ tɕ ɐ k
깨죽깨죽	k͈ ɛ tɕ u k k͈ ɛ tɕ u k
깨지락깨지락	k͈ ɛ tɕ i ɭ ɐ k k͈ ɛ tɕ i ɭ ɐ k
깩	k͈ ɛ k
깩깩	k͈ ɛ k k͈ ɛ k
깰깩깰깩	k͈ ɛ ɭ k͈ ɛ k k͈ ɛ ɭ k͈ ɛ k
깰깰	k͈ ɛ ɭ k͈ ɛ ɭ
깽	k͈ ɛ ŋ
깽깽	k͈ ɛ ŋ k͈ ɛ ŋ
꺄룩	k͈ j ɐ ɭ u k
꺄룩꺄룩	k͈ j ɐ ɭ u k k͈ j ɐ ɭ u k
꺄우뚱	k͈ j ɐ u t͈ u ŋ
꺄우뚱꺄우뚱	k͈ j ɐ u t͈ u ŋ k͈ j ɐ u t͈ u ŋ
꺄웃	k͈ j ɐ u t
꺄웃꺄웃	k͈ j ɐ u t k͈ j ɐ u t
꺅	k͈ j ɐ k
꺅꺅	k͈ j ɐ k k͈ j ɐ k
꺌꺌	k͈ j ɐ ɭ k͈ j ɐ ɭ
꺼귀꺼귀	k͈ ʌ k w i k͈ ʌ k w i
꺼끌꺼끌	k͈ ʌ k͈ ɨ ɭ k͈ ʌ k͈ ɨ ɭ
꺼덕꺼덕	k͈ ʌ t ʌ k k͈ ʌ t ʌ k
꺼드럭꺼드럭	k͈ ʌ t ɨ ɭ ʌ k k͈ ʌ t ɨ ɭ ʌ k
꺼들먹꺼들먹	k͈ ʌ t ɨ ɭ m ʌ k k͈ ʌ t ɨ ɭ m ʌ k
꺼떡꺼떡	k͈ ʌ t͈ ʌ k k͈ ʌ t͈ ʌ k
꺼뜨럭꺼뜨럭	k͈ ʌ t͈ ɨ ɭ ʌ k k͈ ʌ t͈ ɨ ɭ ʌ k
꺼물꺼물	k͈ ʌ m u ɭ k͈ ʌ m u ɭ
꺼뭇꺼뭇	k͈ ʌ m u t k͈ ʌ m u t
꺼벅	k͈ ʌ p ʌ k
꺼벅꺼벅	k͈ ʌ p ʌ k k͈ ʌ p ʌ k
꺼불꺼불	k͈ ʌ p u ɭ k͈ ʌ p u ɭ
꺼슬꺼슬	k͈ ʌ s ɨ ɭ k͈ ʌ s ɨ ɭ
꺼시시	k͈ ʌ s i s i
꺼이꺼이	k͈ ʌ i k͈ ʌ i
꺼치적꺼치적	k͈ ʌ tɕʰ i tɕ ʌ k k͈ ʌ tɕʰ i tɕ ʌ k
꺼칠꺼칠	k͈ ʌ tɕʰ i ɭ k͈ ʌ tɕʰ i ɭ
꺼칫꺼칫	k͈ ʌ tɕʰ i t k͈ ʌ tɕʰ i t
꺽	k͈ ʌ k
꺽꺽	k͈ ʌ k k͈ ʌ k
꺽꺽푸드덕	k͈ ʌ k k͈ ʌ k pʰ u t ɨ t ʌ k
꺽둑꺽둑	k͈ ʌ k t͈ u k k͈ ʌ k t͈ u k
꺽죽꺽죽	k͈ ʌ k tɕ͈ u k k͈ ʌ k tɕ͈ u k
껀둥껀둥	k͈ ʌ n t u ŋ k͈ ʌ n t u ŋ
껄껄	k͈ ʌ ɭ k͈ ʌ ɭ
껄끔껄끔	k͈ ʌ ɭ k͈ ɨ m k͈ ʌ ɭ k͈ ɨ m
껄떡	k͈ ʌ ɭ t͈ ʌ k
껄떡껄떡	k͈ ʌ ɭ t͈ ʌ k k͈ ʌ ɭ t͈ ʌ k
껄렁	k͈ ʌ ɭ ɭ ʌ ŋ
껄렁껄렁	k͈ ʌ ɭ ɭ ʌ ŋ k͈ ʌ ɭ ɭ ʌ ŋ
껄쭉껄쭉	k͈ ʌ ɭ tɕ͈ u k k͈ ʌ ɭ tɕ͈ u k
껌벅	k͈ ʌ m p ʌ k
껌벅껌벅	k͈ ʌ m p ʌ k k͈ ʌ m p ʌ k
껌뻑	k͈ ʌ m p͈ ʌ k
껌뻑껌뻑	k͈ ʌ m p͈ ʌ k k͈ ʌ m p͈ ʌ k
껌적껌적	k͈ ʌ m tɕ ʌ k k͈ ʌ m tɕ ʌ k
껍신껍신	k͈ ʌ p s͈ i n k͈ ʌ p s͈ i n
껍적껍적	k͈ ʌ p tɕ͈ ʌ k k͈ ʌ p tɕ͈ ʌ k
껍죽껍죽	k͈ ʌ p tɕ͈ u k k͈ ʌ p tɕ͈ u k
껑껑	k͈ ʌ ŋ k͈ ʌ ŋ
껑둥	k͈ ʌ ŋ t u ŋ
껑둥껑둥	k͈ ʌ ŋ t u ŋ k͈ ʌ ŋ t u ŋ
껑뚱	k͈ ʌ ŋ t͈ u ŋ
껑뚱껑뚱	k͈ ʌ ŋ t͈ u ŋ k͈ ʌ ŋ t͈ u ŋ
껑쩡	k͈ ʌ ŋ tɕ͈ ʌ ŋ
껑쩡껑쩡	k͈ ʌ ŋ tɕ͈ ʌ ŋ k͈ ʌ ŋ tɕ͈ ʌ ŋ
껑쭝	k͈ ʌ ŋ tɕ͈ u ŋ
껑쭝껑쭝	k͈ ʌ ŋ tɕ͈ u ŋ k͈ ʌ ŋ tɕ͈ u ŋ
껑청	k͈ ʌ ŋ tɕʰ ʌ ŋ
껑청껑청	k͈ ʌ ŋ tɕʰ ʌ ŋ k͈ ʌ ŋ tɕʰ ʌ ŋ
껑충	k͈ ʌ ŋ tɕʰ u ŋ
껑충껑충	k͈ ʌ ŋ tɕʰ u ŋ k͈ ʌ ŋ tɕʰ u ŋ
께죽께죽	k͈ e tɕ u k k͈ e tɕ u k
께지럭께지럭	k͈ e tɕ i ɭ ʌ k k͈ e tɕ i ɭ ʌ k
꼬기작꼬기작	k͈ o k i tɕ ɐ k k͈ o k i tɕ ɐ k
꼬깃꼬깃	k͈ o k i t k͈ o k i t
꼬꼬댁	k͈ o k͈ o t ɛ k
꼬꼬댁꼬꼬댁	k͈ o k͈ o t ɛ k k͈ o k͈ o t ɛ k
꼬끼오	k͈ o k͈ i o
꼬다케	k͈ o t ɐ kʰ e
꼬당꼬당	k͈ o t ɐ ŋ k͈ o t ɐ ŋ
꼬독꼬독	k͈ o t o k k͈ o t o k
꼬들꼬들	k͈ o t ɨ ɭ k͈ o t ɨ ɭ
꼬르륵	k͈ o ɭ ɨ ɭ ɨ k
꼬르륵꼬르륵	k͈ o ɭ ɨ ɭ ɨ k k͈ o ɭ ɨ ɭ ɨ k
꼬무락꼬무락	k͈ o m u ɭ ɐ k k͈ o m u ɭ ɐ k
꼬물꼬물	k͈ o m u ɭ k͈ o m u ɭ
꼬박	k͈ o p ɐ k
꼬박꼬박	k͈ o p ɐ k k͈ o p ɐ k
꼬부랑꼬부랑	k͈ o p u ɭ ɐ ŋ k͈ o p u ɭ ɐ ŋ
꼬부장꼬부장	k͈ o p u tɕ ɐ ŋ k͈ o p u tɕ ɐ ŋ
꼬불꼬불	k͈ o p u ɭ k͈ o p u ɭ
꼬불탕꼬불탕	k͈ o p u ɭ tʰ ɐ ŋ k͈ o p u ɭ tʰ ɐ ŋ
꼬붓꼬붓	k͈ o p u t k͈ o p u t
꼬빡	k͈ o p͈ ɐ k
꼬빡꼬빡	k͈ o p͈ ɐ k k͈ o p͈ ɐ k
꼬약꼬약	k͈ o j ɐ k k͈ o j ɐ k
꼬장꼬장	k͈ o tɕ ɐ ŋ k͈ o tɕ ɐ ŋ
꼬지꼬지	k͈ o tɕ i k͈ o tɕ i
꼬질꼬질	k͈ o tɕ i ɭ k͈ o tɕ i ɭ
꼬치꼬치	k͈ o tɕʰ i k͈ o tɕʰ i
꼭	k͈ o k
꼭꼭	k͈ o k k͈ o k
꼰질꼰질	k͈ o n tɕ i ɭ k͈ o n tɕ i ɭ
꼴깍	k͈ o ɭ k͈ ɐ k
꼴깍꼴깍	k͈ o ɭ k͈ ɐ k k͈ o ɭ k͈ ɐ k
꼴꼴	k͈ o ɭ k͈ o ɭ
꼴딱	k͈ o ɭ t͈ ɐ k
꼴딱꼴딱	k͈ o ɭ t͈ ɐ k k͈ o ɭ t͈ ɐ k
꼴랑	k͈ o ɭ ɭ ɐ ŋ
꼴랑꼴랑	k͈ o ɭ ɭ ɐ ŋ k͈ o ɭ ɭ ɐ ŋ
꼴짝	k͈ o ɭ tɕ͈ ɐ k
꼴짝꼴짝	k͈ o ɭ tɕ͈ ɐ k k͈ o ɭ tɕ͈ ɐ k
꼴찌락	k͈ o ɭ tɕ͈ i ɭ ɐ k
꼴찌락꼴찌락	k͈ o ɭ tɕ͈ i ɭ ɐ k k͈ o ɭ tɕ͈ i ɭ ɐ k
꼴칵	k͈ o ɭ kʰ ɐ k
꼴칵꼴칵	k͈ o ɭ kʰ ɐ k k͈ o ɭ kʰ ɐ k
꼼꼼	k͈ o m k͈ o m
꼼실꼼실	k͈ o m s i ɭ k͈ o m s i ɭ
꼼작	k͈ o m tɕ ɐ k
꼼작꼼작	k͈ o m tɕ ɐ k k͈ o m tɕ ɐ k
꼼지락	k͈ o m tɕ i ɭ ɐ k
꼼지락꼼지락	k͈ o m tɕ i ɭ ɐ k k͈ o m tɕ i ɭ ɐ k
꼼짝	k͈ o m tɕ͈ ɐ k
꼼짝꼼짝	k͈ o m tɕ͈ ɐ k k͈ o m tɕ͈ ɐ k
꼼짝달싹	k͈ o m tɕ͈ ɐ k t͈ ɐ ɭ s͈ ɐ k
꼼트락꼼트락	k͈ o m tʰ ɨ ɭ ɐ k k͈ o m tʰ ɨ ɭ ɐ k
꼼틀	k͈ o m tʰ ɨ ɭ
꼼틀꼼틀	k͈ o m tʰ ɨ ɭ k͈ o m tʰ ɨ ɭ
꼽슬꼽슬	k͈ o p s͈ ɨ ɭ k͈ o p s͈ ɨ ɭ
꼽실	k͈ o p s͈ i ɭ
꼽실꼽실	k͈ o p s͈ i ɭ k͈ o p s͈ i ɭ
꼽작	k͈ o p tɕ͈ ɐ k
꼽작꼽작	k͈ o p tɕ͈ ɐ k k͈ o p tɕ͈ ɐ k
꽁	k͈ o ŋ
꽁꽁	k͈ o ŋ k͈ o ŋ
꽁알꽁알	k͈ o ŋ ɐ ɭ k͈ o ŋ ɐ ɭ
꽈당	k͈ w ɐ t ɐ ŋ
꽈당꽈당	k͈ w ɐ t ɐ ŋ k͈ w ɐ t ɐ ŋ
꽈르르	k͈ w ɐ ɭ ɨ ɭ ɨ
꽈르릉	k͈ w ɐ ɭ ɨ ɭ ɨ ŋ
꽈르릉꽈르릉	k͈ w ɐ ɭ ɨ ɭ ɨ ŋ k͈ w ɐ ɭ ɨ ɭ ɨ ŋ
꽉	k͈ w ɐ k
꽉꽉	k͈ w ɐ k k͈ w ɐ k
꽐꽐	k͈ w ɐ ɭ k͈ w ɐ ɭ
꽝	k͈ w ɐ ŋ
꽝꽝	k͈ w ɐ ŋ k͈ w ɐ ŋ
꽥	k͈ w ɛ k
꽥꽥	k͈ w ɛ k k͈ w ɛ k
꽹	k͈ w ɛ ŋ
꽹그랑	k͈ w ɛ ŋ k ɨ ɭ ɐ ŋ
꽹그랑꽹그랑	k͈ w ɛ ŋ k ɨ ɭ ɐ ŋ k͈ w ɛ ŋ k ɨ ɭ ɐ ŋ
꽹꽹	k͈ w ɛ ŋ k͈ w ɛ ŋ
꾀꼴	k͈ w e k͈ o ɭ
꾀꼴꾀꼴	k͈ w e k͈ o ɭ k͈ w e k͈ o ɭ
꾀꾀	k͈ w e k͈ w e
꾀음꾀음	k͈ w e ɨ m k͈ w e ɨ m
꾸기적꾸기적	k͈ u k i tɕ ʌ k k͈ u k i tɕ ʌ k
꾸깃꾸깃	k͈ u k i t k͈ u k i t
꾸꾸	k͈ u k͈ u
꾸덕꾸덕	k͈ u t ʌ k k͈ u t ʌ k
꾸둑꾸둑	k͈ u t u k k͈ u t u k
꾸들꾸들	k͈ u t ɨ ɭ k͈ u t ɨ ɭ
꾸르륵	k͈ u ɭ ɨ ɭ ɨ k
꾸르륵꾸르륵	k͈ u ɭ ɨ ɭ ɨ k k͈ u ɭ ɨ ɭ ɨ k
꾸무럭꾸무럭	k͈ u m u ɭ ʌ k k͈ u m u ɭ ʌ k
꾸물꾸물	k͈ u m u ɭ k͈ u m u ɭ
꾸벅	k͈ u p ʌ k
꾸벅꾸벅	k͈ u p ʌ k k͈ u p ʌ k
꾸부렁꾸부렁	k͈ u p u ɭ ʌ ŋ k͈ u p u ɭ ʌ ŋ
꾸부정꾸부정	k͈ u p u tɕ ʌ ŋ k͈ u p u tɕ ʌ ŋ
꾸불꾸불	k͈ u p u ɭ k͈ u p u ɭ
꾸불텅꾸불텅	k͈ u p u ɭ tʰ ʌ ŋ k͈ u p u ɭ tʰ ʌ ŋ
꾸붓꾸붓	k͈ u p u t k͈ u p u t
꾸뻑	k͈ u p͈ ʌ k
꾸뻑꾸뻑	k͈ u p͈ ʌ k k͈ u p͈ ʌ k
꾸역꾸역	k͈ u j ʌ k k͈ u j ʌ k
꾸정꾸정	k͈ u tɕ ʌ ŋ k͈ u tɕ ʌ ŋ
꾸질꾸질	k͈ u tɕ i ɭ k͈ u tɕ i ɭ
꾹	k͈ u k
꾹꾹	k͈ u k k͈ u k
꿀꺽	k͈ u ɭ k͈ ʌ k
꿀꺽꿀꺽	k͈ u ɭ k͈ ʌ k k͈ u ɭ k͈ ʌ k
꿀꿀	k͈ u ɭ k͈ u ɭ
꿀떡	k͈ u ɭ t͈ ʌ k
꿀떡꿀떡	k͈ u ɭ t͈ ʌ k k͈ u ɭ t͈ ʌ k
꿀렁	k͈ u ɭ ɭ ʌ ŋ
꿀렁꿀렁	k͈ u ɭ ɭ ʌ ŋ k͈ u ɭ ɭ ʌ ŋ
꿀쩍	k͈ u ɭ tɕ͈ ʌ k
꿀쩍꿀쩍	k͈ u ɭ tɕ͈ ʌ k k͈ u ɭ tɕ͈ ʌ k
꿀찌럭	k͈ u ɭ tɕ͈ i ɭ ʌ k
꿀찌럭꿀찌럭	k͈ u ɭ tɕ͈ i ɭ ʌ k k͈ u ɭ tɕ͈ i ɭ ʌ k
꿀컥	k͈ u ɭ kʰ ʌ k
꿀컥꿀컥	k͈ u ɭ kʰ ʌ k k͈ u ɭ kʰ ʌ k
꿈실꿈실	k͈ u m s i ɭ k͈ u m s i ɭ
꿈적	k͈ u m tɕ ʌ k
꿈적꿈적	k͈ u m tɕ ʌ k k͈ u m tɕ ʌ k
꿈지럭	k͈ u m tɕ i ɭ ʌ k
꿈지럭꿈지럭	k͈ u m tɕ i ɭ ʌ k k͈ u m tɕ i ɭ ʌ k
꿈쩍	k͈ u m tɕ͈ ʌ k
꿈쩍꿈쩍	k͈ u m tɕ͈ ʌ k k͈ u m tɕ͈ ʌ k
꿈트럭꿈트럭	k͈ u m tʰ ɨ ɭ ʌ k k͈ u m tʰ ɨ ɭ ʌ k
꿈틀	k͈ u m tʰ ɨ ɭ
꿈틀꿈틀	k͈ u m tʰ ɨ ɭ k͈ u m tʰ ɨ ɭ
꿉슬꿉슬	k͈ u p s͈ ɨ ɭ k͈ u p s͈ ɨ ɭ
꿉실	k͈ u p s͈ i ɭ
꿉실꿉실	k͈ u p s͈ i ɭ k͈ u p s͈ i ɭ
꿉적	k͈ u p tɕ͈ ʌ k
꿉적꿉적	k͈ u p tɕ͈ ʌ k k͈ u p tɕ͈ ʌ k
꿍	k͈ u ŋ
꿍꽝	k͈ u ŋ k͈ w ɐ ŋ
꿍꽝꿍꽝	k͈ u ŋ k͈ w ɐ ŋ k͈ u ŋ k͈ w ɐ ŋ
꿍꿍	k͈ u ŋ k͈ u ŋ
꿍얼꿍얼	k͈ u ŋ ʌ ɭ k͈ u ŋ ʌ ɭ
꿔르르	k͈ w ʌ ɭ ɨ ɭ ɨ
꿜꿜	k͈ w ʌ ɭ k͈ w ʌ ɭ
꿩	k͈ w ʌ ŋ
꿩꿩	k͈ w ʌ ŋ k͈ w ʌ ŋ
꿱	k͈ w e k
꿱꿱	k͈ w e k k͈ w e k
끄덕	k͈ ɨ t ʌ k
끄덕끄덕	k͈ ɨ t ʌ k k͈ ɨ t ʌ k
끄떡	k͈ ɨ t͈ ʌ k
끄떡끄떡	k͈ ɨ t͈ ʌ k k͈ ɨ t͈ ʌ k
끄르륵	k͈ ɨ ɭ ɨ ɭ ɨ k
끄르륵끄르륵	k͈ ɨ ɭ ɨ ɭ ɨ k k͈ ɨ ɭ ɨ ɭ ɨ k
끄먹끄먹	k͈ ɨ m ʌ k k͈ ɨ m ʌ k
끄물끄물	k͈ ɨ m u ɭ k͈ ɨ m u ɭ
끄적끄적	k͈ ɨ tɕ ʌ k k͈ ɨ tɕ ʌ k
끅	k͈ ɨ k
끅끅	k͈ ɨ k k͈ ɨ k
끈덕끈덕	k͈ ɨ n t ʌ k k͈ ɨ n t ʌ k
끈떡끈떡	k͈ ɨ n t͈ ʌ k k͈ ɨ n t͈ ʌ k
끈적끈적	k͈ ɨ n tɕ ʌ k k͈ ɨ n tɕ ʌ k
끈질끈질	k͈ ɨ n tɕ i ɭ k͈ ɨ n tɕ i ɭ
끌꺽	k͈ ɨ ɭ k͈ ʌ k
끌꺽끌꺽	k͈ ɨ ɭ k͈ ʌ k k͈ ɨ ɭ k͈ ʌ k
끌끌	k͈ ɨ ɭ k͈ ɨ ɭ
끌쩍끌쩍	k͈ ɨ ɭ tɕ͈ ʌ k k͈ ɨ ɭ tɕ͈ ʌ k
끔벅	k͈ ɨ m p ʌ k
끔벅끔벅	k͈ ɨ m p ʌ k k͈ ɨ m p ʌ k
끔뻑	k͈ ɨ m p͈ ʌ k
끔뻑끔뻑	k͈ ɨ m p͈ ʌ k k͈ ɨ m p͈ ʌ k
끔적	k͈ ɨ m tɕ ʌ k
끔적끔적	k͈ ɨ m tɕ ʌ k k͈ ɨ m tɕ ʌ k
끔쩍	k͈ ɨ m tɕ͈ ʌ k
끔쩍끔쩍	k͈ ɨ m tɕ͈ ʌ k k͈ ɨ m tɕ͈ ʌ k
끙	k͈ ɨ ŋ
끙끙	k͈ ɨ ŋ k͈ ɨ ŋ
끼깅	k͈ i k i ŋ
끼깅끼깅	k͈ i k i ŋ k͈ i k i ŋ
끼루룩	k͈ i ɭ u ɭ u k
끼루룩끼루룩	k͈ i ɭ u ɭ u k k͈ i ɭ u ɭ u k
끼룩	k͈ i ɭ u k
끼룩끼루룩	k͈ i ɭ u k k͈ i ɭ u ɭ u k
끼룩끼룩	k͈ i ɭ u k k͈ i ɭ u k
끼우뚱	k͈ i u t͈ u ŋ
끼우뚱끼우뚱	k͈ i u t͈ u ŋ k͈ i u t͈ u ŋ
끼웃	k͈ i u t
끼웃끼웃	k͈ i u t k͈ i u t
끼익	k͈ i i k
끼적끼적	k͈ i tɕ ʌ k k͈ i tɕ ʌ k
끽	k͈ i k
끽끽	k͈ i k k͈ i k
낄끽낄끽	k͈ i ɭ k͈ i k k͈ i ɭ k͈ i k
낄낄	k͈ i ɭ k͈ i ɭ
낑	k͈ i ŋ
낑낑	k͈ i ŋ k͈ i ŋ
나근나근	n ɐ k ɨ n n ɐ k ɨ n
나긋나긋	n ɐ k ɨ n n ɐ k ɨ t
나닥나닥	n ɐ t ɐ ŋ n ɐ t ɐ k
나달나달	n ɐ t ɐ ɭ ɭ ɐ t ɐ ɭ
나릿나릿	n ɐ ɭ i n n ɐ ɭ i t
나박나박	n ɐ p ɐ ŋ n ɐ p ɐ k
나부시	n ɐ p u s i
나부죽	n ɐ p u tɕ u k
나불나불	n ɐ p u ɭ ɭ ɐ p u ɭ
나붓나붓	n ɐ p u n n ɐ p u t
나스르르	n ɐ s ɨ ɭ ɨ ɭ ɨ
나슬나슬	n ɐ s ɨ ɭ ɭ ɐ s ɨ ɭ
나울나울	n ɐ u ɭ ɭ ɐ u ɭ
나직나직	n ɐ tɕ i ŋ n ɐ tɕ i k
나탈나탈	n ɐ tʰ ɐ ɭ ɭ ɐ tʰ ɐ ɭ
나팔나팔	n ɐ pʰ ɐ ɭ ɭ ɐ pʰ ɐ ɭ
나푼	n ɐ pʰ u n
나푼나푼	n ɐ pʰ u n n ɐ pʰ u n
나풀나풀	n ɐ pʰ u ɭ ɭ ɐ pʰ u ɭ
나풋나풋	n ɐ pʰ u n n ɐ pʰ u t
난작난작	n ɐ n tɕ ɐ ŋ n ɐ n tɕ ɐ k
난지락난지락	n ɐ n tɕ i ɭ ɐ ŋ n ɐ n tɕ i ɭ ɐ k
난질난질	n ɐ n tɕ i ɭ ɭ ɐ n tɕ i ɭ
날름	n ɐ ɭ ɭ ɨ m
날름날름	n ɐ ɭ ɭ ɨ m n ɐ ɭ ɭ ɨ m
날쌍날쌍	n ɐ ɭ s͈ ɐ ŋ n ɐ ɭ s͈ ɐ ŋ
날씬날씬	n ɐ ɭ s͈ i n n ɐ ɭ s͈ i n
날짱날짱	n ɐ ɭ tɕ͈ ɐ ŋ n ɐ ɭ tɕ͈ ɐ ŋ
날캉날캉	n ɐ ɭ kʰ ɐ ŋ n ɐ ɭ kʰ ɐ ŋ
날큰날큰	n ɐ ɭ kʰ ɨ n n ɐ ɭ kʰ ɨ n
남몰래	n ɐ m m o ɭ ɭ ɛ
남상남상	n ɐ m s ɐ ŋ n ɐ m s ɐ ŋ
남실남실	n ɐ m s i ɭ ɭ ɐ m s i ɭ
납신	n ɐ p s͈ i n
납신납신	n ɐ p s͈ i n n ɐ p s͈ i n
납작	n ɐ p tɕ͈ ɐ k
납작납작	n ɐ p tɕ͈ ɐ ŋ n ɐ p tɕ͈ ɐ k
납죽	n ɐ p tɕ͈ u k
납죽납죽	n ɐ p tɕ͈ u ŋ n ɐ p tɕ͈ u k
낭창낭창	n ɐ ŋ tɕʰ ɐ ŋ n ɐ ŋ tɕʰ ɐ ŋ
내광쓰광	n ɛ k w ɐ ŋ s͈ ɨ k w ɐ ŋ
내치락들이치락	n ɛ tɕʰ i ɭ ɐ k t͈ ɨ ɭ i tɕʰ i ɭ ɐ k
냅다	n ɛ p t͈ ɐ
너글너글	n ʌ k ɨ ɭ ɭ ʌ k ɨ ɭ
너덕너덕	n ʌ t ʌ ŋ n ʌ t ʌ k
너덜너덜	n ʌ t ʌ ɭ ɭ ʌ t ʌ ɭ
너부시	n ʌ p u s i
너부죽	n ʌ p u tɕ u k
너불너불	n ʌ p u ɭ ɭ ʌ p u ɭ
너붓너붓	n ʌ p u n n ʌ p u t
너스르르	n ʌ s ɨ ɭ ɨ ɭ ɨ
너슬너슬	n ʌ s ɨ ɭ ɭ ʌ s ɨ ɭ
너울너울	n ʌ u ɭ ɭ ʌ u ɭ
너절너절	n ʌ tɕ ʌ ɭ ɭ ʌ tɕ ʌ ɭ
너털너털	n ʌ tʰ ʌ ɭ ɭ ʌ tʰ ʌ ɭ
너펄너펄	n ʌ pʰ ʌ ɭ ɭ ʌ pʰ ʌ ɭ
너푼	n ʌ pʰ u n
너푼너푼	n ʌ pʰ u n n ʌ pʰ u n
너풀너풀	n ʌ pʰ u ɭ ɭ ʌ pʰ u ɭ
넌들넌들	n ʌ n t ɨ ɭ ɭ ʌ n t ɨ ɭ
널름	n ʌ ɭ ɭ ɨ m
널름널름	n ʌ ɭ ɭ ɨ m n ʌ ɭ ɭ ɨ m
널찍널찍	n ʌ ɭ tɕ͈ i ŋ n ʌ ɭ tɕ͈ i k
넓적넓적	n ʌ ɭ tɕ͈ ʌ ŋ n ʌ ɭ tɕ͈ ʌ k
넓죽넓죽	n ʌ ɭ tɕ͈ u ŋ n ʌ ɭ tɕ͈ u k
넘성넘성	n ʌ m s ʌ ŋ n ʌ m s ʌ ŋ
넘실넘실	n ʌ m s i ɭ ɭ ʌ m s i ɭ
넙신	n ʌ p s͈ i n
넙신넙신	n ʌ p s͈ i n n ʌ p s͈ i n
넙적	n ʌ p tɕ͈ ʌ k
넙적넙적	n ʌ p tɕ͈ ʌ ŋ n ʌ p tɕ͈ ʌ k
넙죽	n ʌ p tɕ͈ u k
넙죽넙죽	n ʌ p tɕ͈ u ŋ n ʌ p tɕ͈ u k
노글노글	n o k ɨ ɭ ɭ o k ɨ ɭ
노긋노긋	n o k ɨ n n o k ɨ t
노닥노닥	n o t ɐ ŋ n o t ɐ k
노드리듯	n o t ɨ ɭ i t ɨ t
노름노름	n o ɭ ɨ m n o ɭ ɨ m
노릇노릇	n o ɭ ɨ n n o ɭ ɨ t
녹신녹신	n o k s͈ i n n o k s͈ i n
녹실녹실	n o k s͈ i ɭ ɭ o k s͈ i ɭ
녹진녹진	n o k tɕ͈ i n n o k tɕ͈ i n
높으락낮으락	n o pʰ ɨ ɭ ɐ ŋ n ɐ tɕ ɨ ɭ ɐ k
높지거니	n o p tɕ͈ i k ʌ n i
높직높직	n o p tɕ͈ i ŋ n o p tɕ͈ i k
누글누글	n u k ɨ ɭ ɭ u k ɨ ɭ
누긋누긋	n u k ɨ n n u k ɨ t
누덕누덕	n u t ʌ ŋ n u t ʌ k
누렁누렁	n u ɭ ʌ ŋ n u ɭ ʌ ŋ
누르락붉으락	n u ɭ ɨ ɭ ɐ k p͈ u ɭ k ɨ ɭ ɐ k
누르락푸르락	n u ɭ ɨ ɭ ɐ k pʰ u ɭ ɨ ɭ ɐ k
누름누름	n u ɭ ɨ m n u ɭ ɨ m
누릇누릇	n u ɭ ɨ n n u ɭ ɨ t
눅신눅신	n u k s͈ i n n u k s͈ i n
눅실눅실	n u k s͈ i ɭ ɭ u k s͈ i ɭ
눅진눅진	n u k tɕ͈ i n n u k tɕ͈ i n
뉘엿뉘엿	n w i j ʌ n n w i j ʌ t
느근느근	n ɨ k ɨ n n ɨ k ɨ n
느글느글	n ɨ k ɨ ɭ ɭ ɨ k ɨ ɭ
느긋느긋	n ɨ k ɨ n n ɨ k ɨ t
느럭느럭	n ɨ ɭ ʌ ŋ n ɨ ɭ ʌ k
느릿느릿	n ɨ ɭ i n n ɨ ɭ i t
느물느물	n ɨ m u ɭ ɭ ɨ m u ɭ
느실느실	n ɨ s i ɭ ɭ ɨ s i ɭ
느직느직	n ɨ tɕ i ŋ n ɨ tɕ i k
느짓	n ɨ tɕ i t
느짓느짓	n ɨ tɕ i n n ɨ tɕ i t
는실난실	n ɨ n s i ɭ ɭ ɐ n s i ɭ
는적는적	n ɨ n tɕ ʌ ŋ n ɨ n tɕ ʌ k
는지럭는지럭	n ɨ n tɕ i ɭ ʌ ŋ n ɨ n tɕ i ɭ ʌ k
는질는질	n ɨ n tɕ i ɭ ɭ ɨ n tɕ i ɭ
늘름	n ɨ ɭ ɭ ɨ m
늘름늘름	n ɨ ɭ ɭ ɨ m n ɨ ɭ ɭ ɨ m
늘썽늘썽	n ɨ ɭ s͈ ʌ ŋ n ɨ ɭ s͈ ʌ ŋ
늘씬늘씬	n ɨ ɭ s͈ i n n ɨ ɭ s͈ i n
늘쩡늘쩡	n ɨ ɭ tɕ͈ ʌ ŋ n ɨ ɭ tɕ͈ ʌ ŋ
늘컹늘컹	n ɨ ɭ kʰ ʌ ŋ n ɨ ɭ kʰ ʌ ŋ
늘큰늘큰	n ɨ ɭ kʰ ɨ n n ɨ ɭ kʰ ɨ n
늠실늠실	n ɨ m s i ɭ ɭ ɨ m s i ɭ
능글능글	n ɨ ŋ k ɨ ɭ ɭ ɨ ŋ k ɨ ɭ
능청능청	n ɨ ŋ tɕʰ ʌ ŋ n ɨ ŋ tɕʰ ʌ ŋ
늴리리	n i ɭ ɭ i ɭ i
늴리리쿵더쿵	n i ɭ ɭ i ɭ i kʰ u ŋ t ʌ kʰ u ŋ
니글니글	n i k ɨ ɭ ɭ i k ɨ ɭ
다다닥	t ɐ t ɐ t ɐ k
다다닥다다닥	t ɐ t ɐ t ɐ k t͈ ɐ t ɐ t ɐ k
다닥다닥	t ɐ t ɐ k t͈ ɐ t ɐ k
다달다달	t ɐ t ɐ ɭ t ɐ t ɐ ɭ
다독다독	t ɐ t o k t͈ ɐ t o k
다듬다듬	t ɐ t ɨ m t ɐ t ɨ m
다듬작다듬작	t ɐ t ɨ m tɕ ɐ k t͈ ɐ t ɨ m tɕ ɐ k
다락다락	t ɐ ɭ ɐ k t͈ ɐ ɭ ɐ k
다래다래	t ɐ ɭ ɛ t ɐ ɭ ɛ
다르랑	t ɐ ɭ ɨ ɭ ɐ ŋ
다르랑다르랑	t ɐ ɭ ɨ ɭ ɐ ŋ t ɐ ɭ ɨ ɭ ɐ ŋ
다르르	t ɐ ɭ ɨ ɭ ɨ
다르륵	t ɐ ɭ ɨ ɭ ɨ k
다르륵다르륵	t ɐ ɭ ɨ ɭ ɨ k t͈ ɐ ɭ ɨ ɭ ɨ k
다문다문	t ɐ m u n t ɐ m u n
다물다물	t ɐ m u ɭ t ɐ m u ɭ
다박다박	t ɐ p ɐ k t͈ ɐ p ɐ k
다보록다보록	t ɐ p o ɭ o k t͈ ɐ p o ɭ o k
다복다복	t ɐ p o k t͈ ɐ p o k
다불다불	t ɐ p u ɭ t ɐ p u ɭ
다붓다붓	t ɐ p u t t͈ ɐ p u t
다빡	t ɐ p͈ ɐ k
다빡다빡	t ɐ p͈ ɐ k t͈ ɐ p͈ ɐ k
다뿍	t ɐ p͈ u k
다뿍다뿍	t ɐ p͈ u k t͈ ɐ p͈ u k
다팔다팔	t ɐ pʰ ɐ ɭ t ɐ pʰ ɐ ɭ
닥	t ɐ k
닥다그르르	t ɐ k t͈ ɐ k ɨ ɭ ɨ ɭ ɨ
닥다글닥다글	t ɐ k t͈ ɐ k ɨ ɭ t ɐ k t͈ ɐ k ɨ ɭ
닥닥	t ɐ k t͈ ɐ k
닥작닥작	t ɐ k tɕ͈ ɐ k t͈ ɐ k tɕ͈ ɐ k
닥지닥지	t ɐ k tɕ͈ i t ɐ k tɕ͈ i
달가닥	t ɐ ɭ k ɐ t ɐ k
달가닥달가닥	t ɐ ɭ k ɐ t ɐ k t͈ ɐ ɭ k ɐ t ɐ k
달가당	t ɐ ɭ k ɐ t ɐ ŋ
달가당달가당	t ɐ ɭ k ɐ t ɐ ŋ t ɐ ɭ k ɐ t ɐ ŋ
달그락	t ɐ ɭ k ɨ ɭ ɐ k
달그락달그락	t ɐ ɭ k ɨ ɭ ɐ k t͈ ɐ ɭ k ɨ ɭ ɐ k
달그랑	t ɐ ɭ k ɨ ɭ ɐ ŋ
달그랑달그랑	t ɐ ɭ k ɨ ɭ ɐ ŋ t ɐ ɭ k ɨ ɭ ɐ ŋ
달까닥	t ɐ ɭ k͈ ɐ t ɐ k
달까닥달까닥	t ɐ ɭ k͈ ɐ t ɐ k t͈ ɐ ɭ k͈ ɐ t ɐ k
달까당	t ɐ ɭ k͈ ɐ t ɐ ŋ
달까당달까당	t ɐ ɭ k͈ ɐ t ɐ ŋ t ɐ ɭ k͈ ɐ t ɐ ŋ
달달	t ɐ ɭ t ɐ ɭ
달라당	t ɐ ɭ ɭ ɐ t ɐ ŋ
달라당달라당	t ɐ ɭ ɭ ɐ t ɐ ŋ t ɐ ɭ ɭ ɐ t ɐ ŋ
달랑	t ɐ ɭ ɭ ɐ ŋ
달랑달랑	t ɐ ɭ ɭ ɐ ŋ t ɐ ɭ ɭ ɐ ŋ
달래달래	t ɐ ɭ ɭ ɛ t ɐ ɭ ɭ ɛ
달막달막	t ɐ ɭ m ɐ k t͈ ɐ ɭ m ɐ k
달망달망	t ɐ ɭ m ɐ ŋ t ɐ ɭ m ɐ ŋ
달싹	t ɐ ɭ s͈ ɐ k
달싹달싹	t ɐ ɭ s͈ ɐ k t͈ ɐ ɭ s͈ ɐ k
달카닥	t ɐ ɭ kʰ ɐ t ɐ k
달카닥달카닥	t ɐ ɭ kʰ ɐ t ɐ k t͈ ɐ ɭ kʰ ɐ t ɐ k
달카당	t ɐ ɭ kʰ ɐ t ɐ ŋ
달카당달카당	t ɐ ɭ kʰ ɐ t ɐ ŋ t ɐ ɭ kʰ ɐ t ɐ ŋ
담방	t ɐ m p ɐ ŋ
담방담방	t ɐ m p ɐ ŋ t ɐ m p ɐ ŋ
담빡	t ɐ m p͈ ɐ k
담뿍	t ɐ m p͈ u k
담뿍담뿍	t ɐ m p͈ u k t͈ ɐ m p͈ u k
담상담상	t ɐ m s ɐ ŋ t ɐ m s ɐ ŋ
담숭담숭	t ɐ m s u ŋ t ɐ m s u ŋ
담쏙	t ɐ m s͈ o k
담쏙담쏙	t ɐ m s͈ o k t͈ ɐ m s͈ o k
답삭	t ɐ p s͈ ɐ k
답삭답삭	t ɐ p s͈ ɐ k t͈ ɐ p s͈ ɐ k
답작답작	t ɐ p tɕ͈ ɐ k t͈ ɐ p tɕ͈ ɐ k
당글당글	t ɐ ŋ k ɨ ɭ t ɐ ŋ k ɨ ɭ
당실	t ɐ ŋ s i ɭ
당실당실	t ɐ ŋ s i ɭ t ɐ ŋ s i ɭ
당싯당싯	t ɐ ŋ s i t t͈ ɐ ŋ s i t
대각	t ɛ k ɐ k
대각대각	t ɛ k ɐ k t͈ ɛ k ɐ k
대구루루	t ɛ k u ɭ u ɭ u
대굴대굴	t ɛ k u ɭ t ɛ k u ɭ
대그락	t ɛ k ɨ ɭ ɐ k
대그락대그락	t ɛ k ɨ ɭ ɐ k t͈ ɛ k ɨ ɭ ɐ k
대그르르	t ɛ k ɨ ɭ ɨ ɭ ɨ
대글대글	t ɛ k ɨ ɭ t ɛ k ɨ ɭ
대깍	t ɛ k͈ ɐ k
대깍대깍	t ɛ k͈ ɐ k t͈ ɛ k͈ ɐ k
대꾼대꾼	t ɛ k͈ u n t ɛ k͈ u n
대롱	t ɛ ɭ o ŋ
대롱대롱	t ɛ ɭ o ŋ t ɛ ɭ o ŋ
대충대충	t ɛ tɕʰ u ŋ t ɛ tɕʰ u ŋ
댁대구루루	t ɛ k t͈ ɛ k u ɭ u ɭ u
댁대굴	t ɛ k t͈ ɛ k u ɭ
댁대굴댁대굴	t ɛ k t͈ ɛ k u ɭ t ɛ k t͈ ɛ k u ɭ
댕	t ɛ ŋ
댕가당	t ɛ ŋ k ɐ t ɐ ŋ
댕가당댕가당	t ɛ ŋ k ɐ t ɐ ŋ t ɛ ŋ k ɐ t ɐ ŋ
댕갈	t ɛ ŋ k ɐ ɭ
댕갈댕갈	t ɛ ŋ k ɐ ɭ t ɛ ŋ k ɐ ɭ
댕강	t ɛ ŋ k ɐ ŋ
댕그랑	t ɛ ŋ k ɨ ɭ ɐ ŋ
댕그랑댕그랑	t ɛ ŋ k ɨ ɭ ɐ ŋ t ɛ ŋ k ɨ ɭ ɐ ŋ
댕글댕글	t ɛ ŋ k ɨ ɭ t ɛ ŋ k ɨ ɭ
댕댕	t ɛ ŋ t ɛ ŋ
더금더금	t ʌ k ɨ m t ʌ k ɨ m
더께더께	t ʌ k͈ e t ʌ k͈ e
더끔더끔	t ʌ k͈ ɨ m t ʌ k͈ ɨ m
더덕더덕	t ʌ t ʌ k t͈ ʌ t ʌ k
더덜더덜	t ʌ t ʌ ɭ t ʌ t ʌ ɭ
더덩실	t ʌ t ʌ ŋ s i ɭ
더덩실더덩실	t ʌ t ʌ ŋ s i ɭ t ʌ t ʌ ŋ s i ɭ
더듬더듬	t ʌ t ɨ m t ʌ t ɨ m
더듬적더듬적	t ʌ t ɨ m tɕ ʌ k t͈ ʌ t ɨ m tɕ ʌ k
더디	t ʌ tɕ i
더디더디	t ʌ tɕ i t ʌ tɕ i
더럭	t ʌ ɭ ʌ k
더럭더럭	t ʌ ɭ ʌ k t͈ ʌ ɭ ʌ k
더르르	t ʌ ɭ ɨ ɭ ɨ
더벅더벅	t ʌ p ʌ k t͈ ʌ p ʌ k
더부룩더부룩	t ʌ p u ɭ u k t͈ ʌ p u ɭ u k
더북더북	t ʌ p u k t͈ ʌ p u k
더뻑	t ʌ p͈ ʌ k
더뻑더뻑	t ʌ p͈ ʌ k t͈ ʌ p͈ ʌ k
더펄더펄	t ʌ pʰ ʌ ɭ t ʌ pʰ ʌ ɭ
덕더그르르	t ʌ k t͈ ʌ k ɨ ɭ ɨ ɭ ɨ
덕더글덕더글	t ʌ k t͈ ʌ k ɨ ɭ t ʌ k t͈ ʌ k ɨ ɭ
덕적덕적	t ʌ k tɕ͈ ʌ k t͈ ʌ k tɕ͈ ʌ k
덕지덕지	t ʌ k tɕ͈ i t ʌ k tɕ͈ i
덜거덕	t ʌ ɭ k ʌ t ʌ k
덜거덕덜거덕	t ʌ ɭ k ʌ t ʌ k t͈ ʌ ɭ k ʌ t ʌ k
덜거덩	t ʌ ɭ k ʌ t ʌ ŋ
덜거덩덜거덩	t ʌ ɭ k ʌ t ʌ ŋ t ʌ ɭ k ʌ t ʌ ŋ
덜그럭	t ʌ ɭ k ɨ ɭ ʌ k
덜그럭덜그럭	t ʌ ɭ k ɨ ɭ ʌ k t͈ ʌ ɭ k ɨ ɭ ʌ k
덜그렁	t ʌ ɭ k ɨ ɭ ʌ ŋ
덜그렁덜그렁	t ʌ ɭ k ɨ ɭ ʌ ŋ t ʌ ɭ k ɨ ɭ ʌ ŋ
덜꺼덕	t ʌ ɭ k͈ ʌ t ʌ k
덜꺼덕덜꺼덕	t ʌ ɭ k͈ ʌ t ʌ k t͈ ʌ ɭ k͈ ʌ t ʌ k
덜꺼덩	t ʌ ɭ k͈ ʌ t ʌ ŋ
덜꺼덩덜꺼덩	t ʌ ɭ k͈ ʌ t ʌ ŋ t ʌ ɭ k͈ ʌ t ʌ ŋ
덜덜	t ʌ ɭ t ʌ ɭ
덜러덩	t ʌ ɭ ɭ ʌ t ʌ ŋ
덜러덩덜러덩	t ʌ ɭ ɭ ʌ t ʌ ŋ t ʌ ɭ ɭ ʌ t ʌ ŋ
덜렁	t ʌ ɭ ɭ ʌ ŋ
덜렁덜렁	t ʌ ɭ ɭ ʌ ŋ t ʌ ɭ ɭ ʌ ŋ
덜레덜레	t ʌ ɭ ɭ e t ʌ ɭ ɭ e
덜커덕	t ʌ ɭ kʰ ʌ t ʌ k
덜커덕덜커덕	t ʌ ɭ kʰ ʌ t ʌ k t͈ ʌ ɭ kʰ ʌ t ʌ k
덜커덩	t ʌ ɭ kʰ ʌ t ʌ ŋ
덜커덩덜커덩	t ʌ ɭ kʰ ʌ t ʌ ŋ t ʌ ɭ kʰ ʌ t ʌ ŋ
덜컥	t ʌ ɭ kʰ ʌ k
덜컥덜컥	t ʌ ɭ kʰ ʌ k t͈ ʌ ɭ kʰ ʌ k
덜컹	t ʌ ɭ kʰ ʌ ŋ
덜컹덜컹	t ʌ ɭ kʰ ʌ ŋ t ʌ ɭ kʰ ʌ ŋ
덜퍼덕	t ʌ ɭ pʰ ʌ t ʌ k
덤벙	t ʌ m p ʌ ŋ
덤벙덤벙	t ʌ m p ʌ ŋ t ʌ m p ʌ ŋ
덤부렁듬쑥	t ʌ m p u ɭ ʌ ŋ t ɨ m s͈ u k
덤뻑	t ʌ m p͈ ʌ k
덥석	t ʌ p s͈ ʌ k
덥석덥석	t ʌ p s͈ ʌ k t͈ ʌ p s͈ ʌ k
덥적덥적	t ʌ p tɕ͈ ʌ k t͈ ʌ p tɕ͈ ʌ k
덩그러니	t ʌ ŋ k ɨ ɭ ʌ n i
덩그렁	t ʌ ŋ k ɨ ɭ ʌ ŋ
덩더꿍	t ʌ ŋ t ʌ k͈ u ŋ
덩더꿍덩더꿍	t ʌ ŋ t ʌ k͈ u ŋ t ʌ ŋ t ʌ k͈ u ŋ
덩더러꿍	t ʌ ŋ t ʌ ɭ ʌ k͈ u ŋ
덩더럭	t ʌ ŋ t ʌ ɭ ʌ k
덩덩	t ʌ ŋ t ʌ ŋ
덩드럭덩드럭	t ʌ ŋ t ɨ ɭ ʌ k t͈ ʌ ŋ t ɨ ɭ ʌ k
덩실	t ʌ ŋ s i ɭ
덩실덩실	t ʌ ŋ s i ɭ t ʌ ŋ s i ɭ
덩싯덩싯	t ʌ ŋ s i t t͈ ʌ ŋ s i t
덩이덩이	t ʌ ŋ i t ʌ ŋ i
데걱	t e k ʌ k
데걱데걱	t e k ʌ k t͈ e k ʌ k
데구루루	t e k u ɭ u ɭ u
데굴	t e k u ɭ
데굴데굴	t e k u ɭ t e k u ɭ
데그럭	t e k ɨ ɭ ʌ k
데그럭데그럭	t e k ɨ ɭ ʌ k t͈ e k ɨ ɭ ʌ k
데꺽	t e k͈ ʌ k
데꺽데꺽	t e k͈ ʌ k t͈ e k͈ ʌ k
데꾼데꾼	t e k͈ u n t e k͈ u n
데룽	t e ɭ u ŋ
데룽데룽	t e ɭ u ŋ t e ɭ u ŋ
데면데면	t e m j ʌ n t e m j ʌ n
데설데설	t e s ʌ ɭ t e s ʌ ɭ
덱데구루루	t e k t͈ e k u ɭ u ɭ u
덱데굴	t e k t͈ e k u ɭ
덱데굴덱데굴	t e k t͈ e k u ɭ t e k t͈ e k u ɭ
뎅	t e ŋ
뎅강	t e ŋ k ɐ ŋ
뎅강뎅강	t e ŋ k ɐ ŋ t e ŋ k ɐ ŋ
뎅거덩	t e ŋ k ʌ t ʌ ŋ
뎅거덩뎅거덩	t e ŋ k ʌ t ʌ ŋ t e ŋ k ʌ t ʌ ŋ
뎅걸뎅걸	t e ŋ k ʌ ɭ t e ŋ k ʌ ɭ
뎅겅	t e ŋ k ʌ ŋ
뎅그렁	t e ŋ k ɨ ɭ ʌ ŋ
뎅그렁뎅그렁	t e ŋ k ɨ ɭ ʌ ŋ t e ŋ k ɨ ɭ ʌ ŋ
뎅글뎅글	t e ŋ k ɨ ɭ t e ŋ k ɨ ɭ
뎅뎅	t e ŋ t e ŋ
도그르르	t o k ɨ ɭ ɨ ɭ ɨ
도근도근	t o k ɨ n t o k ɨ n
도글도글	t o k ɨ ɭ t o k ɨ ɭ
도닥도닥	t o t ɐ k t͈ o t ɐ k
도담도담	t o t ɐ m t o t ɐ m
도도록도도록	t o t o ɭ o k t͈ o t o ɭ o k
도돌도돌	t o t o ɭ t o t o ɭ
도동실	t o t o ŋ s i ɭ
도란도란	t o ɭ ɐ n t o ɭ ɐ n
도래도래	t o ɭ ɛ t o ɭ ɛ
도렷도렷	t o ɭ j ʌ t t͈ o ɭ j ʌ t
도르르	t o ɭ ɨ ɭ ɨ
도리반도리반	t o ɭ i p ɐ n t o ɭ i p ɐ n
도손도손	t o s o n t o s o n
도톨도톨	t o tʰ o ɭ t o tʰ o ɭ
돌돌	t o ɭ t o ɭ
돌레돌레	t o ɭ ɭ e t o ɭ ɭ e
동	t o ŋ
동강	t o ŋ k ɐ ŋ
동강동강	t o ŋ k ɐ ŋ t o ŋ k ɐ ŋ
동그마니	t o ŋ k ɨ m ɐ n i
동글동글	t o ŋ k ɨ ɭ t o ŋ k ɨ ɭ
동기동기	t o ŋ k i t o ŋ k i
동당	t o ŋ t ɐ ŋ
동당동당	t o ŋ t ɐ ŋ t o ŋ t ɐ ŋ
동동	t o ŋ t o ŋ
동실	t o ŋ s i ɭ
동실동실	t o ŋ s i ɭ t o ŋ s i ɭ
돠르르	t w ɐ ɭ ɨ ɭ ɨ
돨돨	t w ɐ ɭ t w ɐ ɭ
되똑	t w e t͈ o k
되똑되똑	t w e t͈ o k t͈ w e t͈ o k
되똥	t w e t͈ o ŋ
되똥되똥	t w e t͈ o ŋ t w e t͈ o ŋ
되록	t w e ɭ o k
되록되록	t w e ɭ o k t͈ w e ɭ o k
되롱되롱	t w e ɭ o ŋ t w e ɭ o ŋ
되룽되룽	t w e ɭ u ŋ t w e ɭ u ŋ
되작되작	t w e tɕ ɐ k t͈ w e tɕ ɐ k
되착되착	t w e tɕʰ ɐ k t͈ w e tɕʰ ɐ k
두그르르	t u k ɨ ɭ ɨ ɭ ɨ
두근두근	t u k ɨ n t u k ɨ n
두글두글	t u k ɨ ɭ t u k ɨ ɭ
두덕두덕	t u t ʌ k t͈ u t ʌ k
두덜두덜	t u t ʌ ɭ t u t ʌ ɭ
두두룩두두룩	t u t u ɭ u k t͈ u t u ɭ u k
두둘두둘	t u t u ɭ t u t u ɭ
두둥게둥실	t u t u ŋ k e t u ŋ s i ɭ
두둥둥	t u t u ŋ t u ŋ
두둥둥실	t u t u ŋ t u ŋ s i ɭ
두둥실	t u t u ŋ s i ɭ
두둥실두둥실	t u t u ŋ s i ɭ t u t u ŋ s i ɭ
두런두런	t u ɭ ʌ n t u ɭ ʌ n
두렷두렷	t u ɭ j ʌ t t͈ u ɭ j ʌ t
두루두루	t u ɭ u t u ɭ u
두루딱딱이	t u ɭ u t͈ ɐ k t͈ ɐ k i
두룩두룩	t u ɭ u k t͈ u ɭ u k
두르르	t u ɭ ɨ ɭ ɨ
두리두리	t u ɭ i t u ɭ i
두리둥둥	t u ɭ i t u ŋ t u ŋ
두리둥실	t u ɭ i t u ŋ s i ɭ
두리번두리번	t u ɭ i p ʌ n t u ɭ i p ʌ n
두선두선	t u s ʌ n t u s ʌ n
두순두순	t u s u n t u s u n
두툴두툴	t u tʰ u ɭ t u tʰ u ɭ
둘둘	t u ɭ t u ɭ
둘레둘레	t u ɭ ɭ e t u ɭ ɭ e
둥	t u ŋ
둥글둥글	t u ŋ k ɨ ɭ t u ŋ k ɨ ɭ
둥당	t u ŋ t ɐ ŋ
둥당둥당	t u ŋ t ɐ ŋ t u ŋ t ɐ ŋ
둥덩	t u ŋ t ʌ ŋ
둥덩둥덩	t u ŋ t ʌ ŋ t u ŋ t ʌ ŋ
둥덩실	t u ŋ t ʌ ŋ s i ɭ
둥둥	t u ŋ t u ŋ
둥실	t u ŋ s i ɭ
둥실둥실	t u ŋ s i ɭ t u ŋ s i ɭ
둥싯둥싯	t u ŋ s i t t͈ u ŋ s i t
뒤뚝	t w i t͈ u k
뒤뚝뒤뚝	t w i t͈ u k t͈ w i t͈ u k
뒤뚱	t w i t͈ u ŋ
뒤뚱뒤뚱	t w i t͈ u ŋ t w i t͈ u ŋ
뒤룩	t w i ɭ u k
뒤룩뒤룩	t w i ɭ u k t͈ w i ɭ u k
뒤룽뒤룽	t w i ɭ u ŋ t w i ɭ u ŋ
뒤숭숭	t w i s u ŋ s u ŋ
뒤스럭뒤스럭	t w i s ɨ ɭ ʌ k t͈ w i s ɨ ɭ ʌ k
뒤슬뒤슬	t w i s ɨ ɭ t w i s ɨ ɭ
뒤적뒤적	t w i tɕ ʌ k t͈ w i tɕ ʌ k
뒤척뒤척	t w i tɕʰ ʌ k t͈ w i tɕʰ ʌ k
뒤치락엎치락	t w i tɕʰ i ɭ ɐ k ʌ p tɕʰ i ɭ ɐ k
뒹굴뒹굴	t w i ŋ k u ɭ t w i ŋ k u ɭ
드렁드렁	t ɨ ɭ ʌ ŋ t ɨ ɭ ʌ ŋ
드레드레	t ɨ ɭ e t ɨ ɭ e
드르렁	t ɨ ɭ ɨ ɭ ʌ ŋ
드르렁드르렁	t ɨ ɭ ɨ ɭ ʌ ŋ t ɨ ɭ ɨ ɭ ʌ ŋ
드르르	t ɨ ɭ ɨ ɭ ɨ
드르륵	t ɨ ɭ ɨ ɭ ɨ k
드르륵드르륵	t ɨ ɭ ɨ ɭ ɨ k t͈ ɨ ɭ ɨ ɭ ɨ k
드르릉	t ɨ ɭ ɨ ɭ ɨ ŋ
드르릉드르릉	t ɨ ɭ ɨ ɭ ɨ ŋ t ɨ ɭ ɨ ɭ ɨ ŋ
드릉드릉	t ɨ ɭ ɨ ŋ t ɨ ɭ ɨ ŋ
드문드문	t ɨ m u n t ɨ m u n
드뿍	t ɨ p͈ u k
드뿍드뿍	t ɨ p͈ u k t͈ ɨ p͈ u k
득	t ɨ k
득득	t ɨ k t͈ ɨ k
득시글득시글	t ɨ k s͈ i k ɨ ɭ t ɨ k s͈ i k ɨ ɭ
들까불들까불	t ɨ ɭ k͈ ɐ p u ɭ t ɨ ɭ k͈ ɐ p u ɭ
들들	t ɨ ɭ t ɨ ɭ
들락날락	t ɨ ɭ ɭ ɐ ŋ n ɐ ɭ ɭ ɐ k
들랑날랑	t ɨ ɭ ɭ ɐ ŋ n ɐ ɭ ɭ ɐ ŋ
들먹들먹	t ɨ ɭ m ʌ k t͈ ɨ ɭ m ʌ k
들멍들멍	t ɨ ɭ m ʌ ŋ t ɨ ɭ m ʌ ŋ
들썩	t ɨ ɭ s͈ ʌ k
들썩들썩	t ɨ ɭ s͈ ʌ k t͈ ɨ ɭ s͈ ʌ k
들썽들썽	t ɨ ɭ s͈ ʌ ŋ t ɨ ɭ s͈ ʌ ŋ
들쑥날쑥	t ɨ ɭ s͈ u ŋ n ɐ ɭ s͈ u k
들음들음	t ɨ ɭ ɨ m t ɨ ɭ ɨ m
들이치락내치락	t ɨ ɭ i tɕʰ i ɭ ɐ ŋ n ɛ tɕʰ i ɭ ɐ k
들쭉날쭉	t ɨ ɭ tɕ͈ u ŋ n ɐ ɭ tɕ͈ u k
들척들척	t ɨ ɭ tɕʰ ʌ k t͈ ɨ ɭ tɕʰ ʌ k
들큰들큰	t ɨ ɭ kʰ ɨ n t ɨ ɭ kʰ ɨ n
듬뿍	t ɨ m p͈ u k
듬뿍듬뿍	t ɨ m p͈ u k t͈ ɨ m p͈ u k
듬성듬성	t ɨ m s ʌ ŋ t ɨ m s ʌ ŋ
듬쑥	t ɨ m s͈ u k
듬쑥듬쑥	t ɨ m s͈ u k t͈ ɨ m s͈ u k
디그르르	t i k ɨ ɭ ɨ ɭ ɨ
디글디글	t i k ɨ ɭ t i k ɨ ɭ
디룽	t i ɭ u ŋ
디룽디룽	t i ɭ u ŋ t i ɭ u ŋ
딩동	t i ŋ t o ŋ
딩동댕	t i ŋ t o ŋ t ɛ ŋ
딩동딩동	t i ŋ t o ŋ t i ŋ t o ŋ
딩딩	t i ŋ t i ŋ
따끈따끈	t͈ ɐ k͈ ɨ n t͈ ɐ k͈ ɨ n
따끔	t͈ ɐ k͈ ɨ m
따끔따끔	t͈ ɐ k͈ ɨ m t͈ ɐ k͈ ɨ m
따다닥	t͈ ɐ t ɐ t ɐ k
따다닥따다닥	t͈ ɐ t ɐ t ɐ k t͈ ɐ t ɐ t ɐ k
따닥따닥	t͈ ɐ t ɐ k t͈ ɐ t ɐ k
따독따독	t͈ ɐ t o k t͈ ɐ t o k
따듬따듬	t͈ ɐ t ɨ m t͈ ɐ t ɨ m
따듬작따듬작	t͈ ɐ t ɨ m tɕ ɐ k t͈ ɐ t ɨ m tɕ ɐ k
따따따	t͈ ɐ t͈ ɐ t͈ ɐ
따따부따	t͈ ɐ t͈ ɐ p u t͈ ɐ
따르르	t͈ ɐ ɭ ɨ ɭ ɨ
따르륵	t͈ ɐ ɭ ɨ ɭ ɨ k
따르륵따르륵	t͈ ɐ ɭ ɨ ɭ ɨ k t͈ ɐ ɭ ɨ ɭ ɨ k
따르릉	t͈ ɐ ɭ ɨ ɭ ɨ ŋ
따르릉따르릉	t͈ ɐ ɭ ɨ ɭ ɨ ŋ t͈ ɐ ɭ ɨ ɭ ɨ ŋ
따옥따옥	t͈ ɐ o k t͈ ɐ o k
따짝따짝	t͈ ɐ tɕ͈ ɐ k t͈ ɐ tɕ͈ ɐ k
딱	t͈ ɐ k
딱따그르르	t͈ ɐ k t͈ ɐ k ɨ ɭ ɨ ɭ ɨ
딱따글딱따글	t͈ ɐ k t͈ ɐ k ɨ ɭ t͈ ɐ k t͈ ɐ k ɨ ɭ
딱딱	t͈ ɐ k t͈ ɐ k
딱콩	t͈ ɐ k kʰ o ŋ
딱콩딱콩	t͈ ɐ k kʰ o ŋ t͈ ɐ k kʰ o ŋ
딸가닥	t͈ ɐ ɭ k ɐ t ɐ k
딸가닥딸가닥	t͈ ɐ ɭ k ɐ t ɐ k t͈ ɐ ɭ k ɐ t ɐ k
딸가당	t͈ ɐ ɭ k ɐ t ɐ ŋ
딸가당딸가당	t͈ ɐ ɭ k ɐ t ɐ ŋ t͈ ɐ ɭ k ɐ t ɐ ŋ
딸그락	t͈ ɐ ɭ k ɨ ɭ ɐ k
딸그락딸그락	t͈ ɐ ɭ k ɨ ɭ ɐ k t͈ ɐ ɭ k ɨ ɭ ɐ k
딸그랑	t͈ ɐ ɭ k ɨ ɭ ɐ ŋ
딸그랑딸그랑	t͈ ɐ ɭ k ɨ ɭ ɐ ŋ t͈ ɐ ɭ k ɨ ɭ ɐ ŋ
딸까닥	t͈ ɐ ɭ k͈ ɐ t ɐ k
딸까닥딸까닥	t͈ ɐ ɭ k͈ ɐ t ɐ k t͈ ɐ ɭ k͈ ɐ t ɐ k
딸까당	t͈ ɐ ɭ k͈ ɐ t ɐ ŋ
딸까당딸까당	t͈ ɐ ɭ k͈ ɐ t ɐ ŋ t͈ ɐ ɭ k͈ ɐ t ɐ ŋ
딸꾹	t͈ ɐ ɭ k͈ u k
딸꾹딸꾹	t͈ ɐ ɭ k͈ u k t͈ ɐ ɭ k͈ u k
딸딸	t͈ ɐ ɭ t͈ ɐ ɭ
딸랑	t͈ ɐ ɭ ɭ ɐ ŋ
딸랑딸랑	t͈ ɐ ɭ ɭ ɐ ŋ t͈ ɐ ɭ ɭ ɐ ŋ
딸막딸막	t͈ ɐ ɭ m ɐ k t͈ ɐ ɭ m ɐ k
딸싹	t͈ ɐ ɭ s͈ ɐ k
딸싹딸싹	t͈ ɐ ɭ s͈ ɐ k t͈ ɐ ɭ s͈ ɐ k
딸카닥	t͈ ɐ ɭ kʰ ɐ t ɐ k
딸카닥딸카닥	t͈ ɐ ɭ kʰ ɐ t ɐ k t͈ ɐ ɭ kʰ ɐ t ɐ k
딸카당	t͈ ɐ ɭ kʰ ɐ t ɐ ŋ
딸카당딸카당	t͈ ɐ ɭ kʰ ɐ t ɐ ŋ t͈ ɐ ɭ kʰ ɐ t ɐ ŋ
땀직땀직	t͈ ɐ m tɕ i k t͈ ɐ m tɕ i k
땅	t͈ ɐ ŋ
땅땅	t͈ ɐ ŋ t͈ ɐ ŋ
때각	t͈ ɛ k ɐ k
때각때각	t͈ ɛ k ɐ k t͈ ɛ k ɐ k
때구루루	t͈ ɛ k u ɭ u ɭ u
때군때군	t͈ ɛ k u n t͈ ɛ k u n
때굴때굴	t͈ ɛ k u ɭ t͈ ɛ k u ɭ
때그락	t͈ ɛ k ɨ ɭ ɐ k
때그락때그락	t͈ ɛ k ɨ ɭ ɐ k t͈ ɛ k ɨ ɭ ɐ k
때그르르	t͈ ɛ k ɨ ɭ ɨ ɭ ɨ
때글때글	t͈ ɛ k ɨ ɭ t͈ ɛ k ɨ ɭ
때깍	t͈ ɛ k͈ ɐ k
때깍때깍	t͈ ɛ k͈ ɐ k t͈ ɛ k͈ ɐ k
때꾼때꾼	t͈ ɛ k͈ u n t͈ ɛ k͈ u n
땍때구루루	t͈ ɛ k t͈ ɛ k u ɭ u ɭ u
땍때굴	t͈ ɛ k t͈ ɛ k u ɭ
땍때굴땍때굴	t͈ ɛ k t͈ ɛ k u ɭ t͈ ɛ k t͈ ɛ k u ɭ
땍땍	t͈ ɛ k t͈ ɛ k
땡	t͈ ɛ ŋ
땡가당	t͈ ɛ ŋ k ɐ t ɐ ŋ
땡가당땡가당	t͈ ɛ ŋ k ɐ t ɐ ŋ t͈ ɛ ŋ k ɐ t ɐ ŋ
땡그랑	t͈ ɛ ŋ k ɨ ɭ ɐ ŋ
땡그랑땡그랑	t͈ ɛ ŋ k ɨ ɭ ɐ ŋ t͈ ɛ ŋ k ɨ ɭ ɐ ŋ
땡글땡글	t͈ ɛ ŋ k ɨ ɭ t͈ ɛ ŋ k ɨ ɭ
땡땡	t͈ ɛ ŋ t͈ ɛ ŋ
떠덕떠덕	t͈ ʌ t ʌ k t͈ ʌ t ʌ k
떠들썩떠들썩	t͈ ʌ t ɨ ɭ s͈ ʌ k t͈ ʌ t ɨ ɭ s͈ ʌ k
떠듬떠듬	t͈ ʌ t ɨ m t͈ ʌ t ɨ m
떠듬적떠듬적	t͈ ʌ t ɨ m tɕ ʌ k t͈ ʌ t ɨ m tɕ ʌ k
떠죽떠죽	t͈ ʌ tɕ u k t͈ ʌ tɕ u k
떡	t͈ ʌ k
떡떠그르르	t͈ ʌ k t͈ ʌ k ɨ ɭ ɨ ɭ ɨ
떡떠글떡떠글	t͈ ʌ k t͈ ʌ k ɨ ɭ t͈ ʌ k t͈ ʌ k ɨ ɭ
떡떡	t͈ ʌ k t͈ ʌ k
떨거덕	t͈ ʌ ɭ k ʌ t ʌ k
떨거덕떨거덕	t͈ ʌ ɭ k ʌ t ʌ k t͈ ʌ ɭ k ʌ t ʌ k
떨거덩	t͈ ʌ ɭ k ʌ t ʌ ŋ
떨거덩떨거덩	t͈ ʌ ɭ k ʌ t ʌ ŋ t͈ ʌ ɭ k ʌ t ʌ ŋ
떨그럭	t͈ ʌ ɭ k ɨ ɭ ʌ k
떨그럭떨그럭	t͈ ʌ ɭ k ɨ ɭ ʌ k t͈ ʌ ɭ k ɨ ɭ ʌ k
떨그렁	t͈ ʌ ɭ k ɨ ɭ ʌ ŋ
떨그렁떨그렁	t͈ ʌ ɭ k ɨ ɭ ʌ ŋ t͈ ʌ ɭ k ɨ ɭ ʌ ŋ
떨꺼덕	t͈ ʌ ɭ k͈ ʌ t ʌ k
떨꺼덕떨꺼덕	t͈ ʌ ɭ k͈ ʌ t ʌ k t͈ ʌ ɭ k͈ ʌ t ʌ k
떨꺼덩	t͈ ʌ ɭ k͈ ʌ t ʌ ŋ
떨꺼덩떨꺼덩	t͈ ʌ ɭ k͈ ʌ t ʌ ŋ t͈ ʌ ɭ k͈ ʌ t ʌ ŋ
떨떨	t͈ ʌ ɭ t͈ ʌ ɭ
떨렁	t͈ ʌ ɭ ɭ ʌ ŋ
떨렁떨렁	t͈ ʌ ɭ ɭ ʌ ŋ t͈ ʌ ɭ ɭ ʌ ŋ
떨커덕	t͈ ʌ ɭ kʰ ʌ t ʌ k
떨커덕떨커덕	t͈ ʌ ɭ kʰ ʌ t ʌ k t͈ ʌ ɭ kʰ ʌ t ʌ k
떨커덩	t͈ ʌ ɭ kʰ ʌ t ʌ ŋ
떨커덩떨커덩	t͈ ʌ ɭ kʰ ʌ t ʌ ŋ t͈ ʌ ɭ kʰ ʌ t ʌ ŋ
떵	t͈ ʌ ŋ
떵기떵기	t͈ ʌ ŋ k i t͈ ʌ ŋ k i
떵떵	t͈ ʌ ŋ t͈ ʌ ŋ
떼걱	t͈ e k ʌ k
떼걱떼걱	t͈ e k ʌ k t͈ e k ʌ k
떼구루루	t͈ e k u ɭ u ɭ u
떼굴떼굴	t͈ e k u ɭ t͈ e k u ɭ
떼그럭	t͈ e k ɨ ɭ ʌ k
떼그럭떼그럭	t͈ e k ɨ ɭ ʌ k t͈ e k ɨ ɭ ʌ k
떼꺽	t͈ e k͈ ʌ k
떼꺽떼꺽	t͈ e k͈ ʌ k t͈ e k͈ ʌ k
떼꾼떼꾼	t͈ e k͈ u n t͈ e k͈ u n
떽떼구루루	t͈ e k t͈ e k u ɭ u ɭ u
떽떼굴	t͈ e k t͈ e k u ɭ
떽떼굴떽떼굴	t͈ e k t͈ e k u ɭ t͈ e k t͈ e k u ɭ
떽떽	t͈ e k t͈ e k
뗑	t͈ e ŋ
뗑거덩	t͈ e ŋ k ʌ t ʌ ŋ
뗑거덩뗑거덩	t͈ e ŋ k ʌ t ʌ ŋ t͈ e ŋ k ʌ t ʌ ŋ
뗑그렁	t͈ e ŋ k ɨ ɭ ʌ ŋ
뗑그렁뗑그렁	t͈ e ŋ k ɨ ɭ ʌ ŋ t͈ e ŋ k ɨ ɭ ʌ ŋ
뗑뗑	t͈ e ŋ t͈ e ŋ
또각또각	t͈ o k ɐ k t͈ o k ɐ k
또그르르	t͈ o k ɨ ɭ ɨ ɭ ɨ
또글또글	t͈ o k ɨ ɭ t͈ o k ɨ ɭ
또깡또깡	t͈ o k͈ ɐ ŋ t͈ o k͈ ɐ ŋ
또닥또닥	t͈ o t ɐ k t͈ o t ɐ k
또드락또드락	t͈ o t ɨ ɭ ɐ k t͈ o t ɨ ɭ ɐ k
또랑또랑	t͈ o ɭ ɐ ŋ t͈ o ɭ ɐ ŋ
또렷또렷	t͈ o ɭ j ʌ t t͈ o ɭ j ʌ t
또록또록	t͈ o ɭ o k t͈ o ɭ o k
또르르	t͈ o ɭ ɨ ɭ ɨ
또박또박	t͈ o p ɐ k t͈ o p ɐ k
똑	t͈ o k
똑딱	t͈ o k t͈ ɐ k
똑딱똑딱	t͈ o k t͈ ɐ k t͈ o k t͈ ɐ k
똑똑	t͈ o k t͈ o k
똘똘	t͈ o ɭ t͈ o ɭ
똘망똘망	t͈ o ɭ m ɐ ŋ t͈ o ɭ m ɐ ŋ
똥글똥글	t͈ o ŋ k ɨ ɭ t͈ o ŋ k ɨ ɭ
똥땅	t͈ o ŋ t͈ ɐ ŋ
똥땅똥땅	t͈ o ŋ t͈ ɐ ŋ t͈ o ŋ t͈ ɐ ŋ
똥또도롬	t͈ o ŋ t͈ o t o ɭ o m
똥똥	t͈ o ŋ t͈ o ŋ
똬르르	t͈ w ɐ ɭ ɨ ɭ ɨ
똴똴	t͈ w ɐ ɭ t͈ w ɐ ɭ
뙤뙤	t͈ w e t͈ w e
뙤록	t͈ w e ɭ o k
뙤록뙤록	t͈ w e ɭ o k t͈ w e ɭ o k
뚜	t͈ u
뚜그르르	t͈ u k ɨ ɭ ɨ ɭ ɨ
뚜글뚜글	t͈ u k ɨ ɭ t͈ u k ɨ ɭ
뚜덕뚜덕	t͈ u t ʌ k t͈ u t ʌ k
뚜덜뚜덜	t͈ u t ʌ ɭ t͈ u t ʌ ɭ
뚜두두둑	t͈ u t u t u t u k
뚜드럭뚜드럭	t͈ u t ɨ ɭ ʌ k t͈ u t ɨ ɭ ʌ k
뚜뚜	t͈ u t͈ u
뚜렛뚜렛	t͈ u ɭ e t t͈ u ɭ e t
뚜렷뚜렷	t͈ u ɭ j ʌ t t͈ u ɭ j ʌ t
뚜르르	t͈ u ɭ ɨ ɭ ɨ
뚜벅	t͈ u p ʌ k
뚜벅뚜벅	t͈ u p ʌ k t͈ u p ʌ k
뚝	t͈ u k
뚝딱	t͈ u k t͈ ɐ k
뚝딱뚝딱	t͈ u k t͈ ɐ k t͈ u k t͈ ɐ k
뚝뚝	t͈ u k t͈ u k
뚤뚤	t͈ u ɭ t͈ u ɭ
뚱글뚱글	t͈ u ŋ k ɨ ɭ t͈ u ŋ k ɨ ɭ
뚱땅	t͈ u ŋ t͈ ɐ ŋ
뚱땅뚱땅	t͈ u ŋ t͈ ɐ ŋ t͈ u ŋ t͈ ɐ ŋ
뚱뚱	t͈ u ŋ t͈ u ŋ
뚱싯뚱싯	t͈ u ŋ s i t t͈ u ŋ s i t
뛰	t͈ w i
뛰뛰	t͈ w i t͈ w i
뛰뛰빵빵	t͈ w i t͈ w i p͈ ɐ ŋ p͈ ɐ ŋ
뛰룩	t͈ w i ɭ u k
뛰룩뛰룩	t͈ w i ɭ u k t͈ w i ɭ u k
뜨끈뜨끈	t͈ ɨ k͈ ɨ n t͈ ɨ k͈ ɨ n
뜨끔	t͈ ɨ k͈ ɨ m
뜨끔따끔	t͈ ɨ k͈ ɨ m t͈ ɐ k͈ ɨ m
뜨끔뜨끔	t͈ ɨ k͈ ɨ m t͈ ɨ k͈ ɨ m
뜨덤뜨덤	t͈ ɨ t ʌ m t͈ ɨ t ʌ m
뜨르르	t͈ ɨ ɭ ɨ ɭ ɨ
뜨르륵	t͈ ɨ ɭ ɨ ɭ ɨ k
뜨르륵뜨르륵	t͈ ɨ ɭ ɨ ɭ ɨ k t͈ ɨ ɭ ɨ ɭ ɨ k
뜨문뜨문	t͈ ɨ m u n t͈ ɨ m u n
뜯적뜯적	t͈ ɨ t tɕ͈ ʌ k t͈ ɨ t tɕ͈ ʌ k
뜰뜰	t͈ ɨ ɭ t͈ ɨ ɭ
뜰먹뜰먹	t͈ ɨ ɭ m ʌ k t͈ ɨ ɭ m ʌ k
뜰썩	t͈ ɨ ɭ s͈ ʌ k
뜰썩뜰썩	t͈ ɨ ɭ s͈ ʌ k t͈ ɨ ɭ s͈ ʌ k
뜸북뜸북	t͈ ɨ m p u k t͈ ɨ m p u k
뜸직뜸직	t͈ ɨ m tɕ i k t͈ ɨ m tɕ i k
띄엄띄엄	t͈ i ʌ m t͈ i ʌ m
띠그르르	t͈ i k ɨ ɭ ɨ ɭ ɨ
띠글띠글	t͈ i k ɨ ɭ t͈ i k ɨ ɭ
띵	t͈ i ŋ
띵까띵까	t͈ i ŋ k͈ ɐ t͈ i ŋ k͈ ɐ
띵동	t͈ i ŋ t o ŋ
띵동띵동	t͈ i ŋ t o ŋ t͈ i ŋ t o ŋ
띵띵	t͈ i ŋ t͈ i ŋ
만지작만지작	m ɐ n tɕ i tɕ ɐ ŋ m ɐ n tɕ i tɕ ɐ k
말긋말긋	m ɐ ɭ k ɨ n m ɐ ɭ k ɨ t
말끄러미	m ɐ ɭ k͈ ɨ ɭ ʌ m i
말똥말똥	m ɐ ɭ t͈ o ŋ m ɐ ɭ t͈ o ŋ
말랑말랑	m ɐ ɭ ɭ ɐ ŋ m ɐ ɭ ɭ ɐ ŋ
말씬	m ɐ ɭ s͈ i n
말씬말씬	m ɐ ɭ s͈ i n m ɐ ɭ s͈ i n
말캉말캉	m ɐ ɭ kʰ ɐ ŋ m ɐ ɭ kʰ ɐ ŋ
망설망설	m ɐ ŋ s ʌ ɭ m ɐ ŋ s ʌ ɭ
망울망울	m ɐ ŋ u ɭ m ɐ ŋ u ɭ
매끄당매끄당	m ɛ k͈ ɨ t ɐ ŋ m ɛ k͈ ɨ t ɐ ŋ
매끈둥매끈둥	m ɛ k͈ ɨ n t u ŋ m ɛ k͈ ɨ n t u ŋ
매끈매끈	m ɛ k͈ ɨ n m ɛ k͈ ɨ n
매끌매끌	m ɛ k͈ ɨ ɭ m ɛ k͈ ɨ ɭ
매매	m ɛ m ɛ
매슥매슥	m ɛ s ɨ ŋ m ɛ s ɨ k
매지매지	m ɛ tɕ i m ɛ tɕ i
맨둥맨둥	m ɛ n t u ŋ m ɛ n t u ŋ
맨송맨송	m ɛ n s o ŋ m ɛ n s o ŋ
맨숭맨숭	m ɛ n s u ŋ m ɛ n s u ŋ
맴	m ɛ m
맴맴	m ɛ m m ɛ m
맹꽁	m ɛ ŋ k͈ o ŋ
맹꽁맹꽁	m ɛ ŋ k͈ o ŋ m ɛ ŋ k͈ o ŋ
맹꽁징꽁	m ɛ ŋ k͈ o ŋ tɕ i ŋ k͈ o ŋ
맹숭맹숭	m ɛ ŋ s u ŋ m ɛ ŋ s u ŋ
먀얄먀얄	m j ɐ j ɐ ɭ m j ɐ j ɐ ɭ
머뭇머뭇	m ʌ m u n m ʌ m u t
멀거니	m ʌ ɭ k ʌ n i
멀뚱멀뚱	m ʌ ɭ t͈ u ŋ m ʌ ɭ t͈ u ŋ
멀찍멀찍	m ʌ ɭ tɕ͈ i ŋ m ʌ ɭ tɕ͈ i k
멈칫	m ʌ m tɕʰ i t
멈칫멈칫	m ʌ m tɕʰ i n m ʌ m tɕʰ i t
멍멍	m ʌ ŋ m ʌ ŋ
멍울멍울	m ʌ ŋ u ɭ m ʌ ŋ u ɭ
멍털멍털	m ʌ ŋ tʰ ʌ ɭ m ʌ ŋ tʰ ʌ ɭ
메슥메슥	m e s ɨ ŋ m e s ɨ k
메지메지	m e tɕ i m e tɕ i
모다기모다기	m o t ɐ k i m o t ɐ k i
모도록	m o t o ɭ o k
모락모락	m o ɭ ɐ ŋ m o ɭ ɐ k
모숨모숨	m o s u m m o s u m
모짝모짝	m o tɕ͈ ɐ ŋ m o tɕ͈ ɐ k
몬닥	m o n t ɐ k
몬닥몬닥	m o n t ɐ ŋ m o n t ɐ k
몬탁	m o n tʰ ɐ k
몬탁몬탁	m o n tʰ ɐ ŋ m o n tʰ ɐ k
몰랑몰랑	m o ɭ ɭ ɐ ŋ m o ɭ ɭ ɐ ŋ
몰몰	m o ɭ m o ɭ
몰씬	m o ɭ s͈ i n
몰씬몰씬	m o ɭ s͈ i n m o ɭ s͈ i n
몰칵	m o ɭ kʰ ɐ k
몰칵몰칵	m o ɭ kʰ ɐ ŋ m o ɭ kʰ ɐ k
몰캉몰캉	m o ɭ kʰ ɐ ŋ m o ɭ kʰ ɐ ŋ
몰큰	m o ɭ kʰ ɨ n
몰큰몰큰	m o ɭ kʰ ɨ n m o ɭ kʰ ɨ n
못내	m o n n ɛ
몽개몽개	m o ŋ k ɛ m o ŋ k ɛ
몽그작몽그작	m o ŋ k ɨ tɕ ɐ ŋ m o ŋ k ɨ tɕ ɐ k
몽글	m o ŋ k ɨ ɭ
몽글몽글	m o ŋ k ɨ ɭ m o ŋ k ɨ ɭ
몽긋몽긋	m o ŋ k ɨ n m o ŋ k ɨ t
몽땅	m o ŋ t͈ ɐ ŋ
몽땅몽땅	m o ŋ t͈ ɐ ŋ m o ŋ t͈ ɐ ŋ
몽똑	m o ŋ t͈ o k
몽똑몽똑	m o ŋ t͈ o ŋ m o ŋ t͈ o k
몽실	m o ŋ s i ɭ
몽실몽실	m o ŋ s i ɭ m o ŋ s i ɭ
몽클	m o ŋ kʰ ɨ ɭ
몽클몽클	m o ŋ kʰ ɨ ɭ m o ŋ kʰ ɨ ɭ
몽탕	m o ŋ tʰ ɐ ŋ
몽탕몽탕	m o ŋ tʰ ɐ ŋ m o ŋ tʰ ɐ ŋ
몽톡	m o ŋ tʰ o k
몽톡몽톡	m o ŋ tʰ o ŋ m o ŋ tʰ o k
무뚝무뚝	m u t͈ u ŋ m u t͈ u k
무뜩	m u t͈ ɨ k
무뜩무뜩	m u t͈ ɨ ŋ m u t͈ ɨ k
무럭무럭	m u ɭ ʌ ŋ m u ɭ ʌ k
무시무시	m u s i m u s i
무쩍무쩍	m u tɕ͈ ʌ ŋ m u tɕ͈ ʌ k
무춤	m u tɕʰ u m
무춤무춤	m u tɕʰ u m m u tɕʰ u m
묵직묵직	m u k tɕ͈ i ŋ m u k tɕ͈ i k
문덕	m u n t ʌ k
문덕문덕	m u n t ʌ ŋ m u n t ʌ k
문득	m u n t ɨ k
문득문득	m u n t ɨ ŋ m u n t ɨ k
문뜩	m u n t͈ ɨ k
문뜩문뜩	m u n t͈ ɨ ŋ m u n t͈ ɨ k
문실문실	m u n s i ɭ m u n s i ɭ
문적	m u n tɕ ʌ k
문적문적	m u n tɕ ʌ ŋ m u n tɕ ʌ k
문척	m u n tɕʰ ʌ k
문척문척	m u n tɕʰ ʌ ŋ m u n tɕʰ ʌ k
문치적문치적	m u n tɕʰ i tɕ ʌ ŋ m u n tɕʰ i tɕ ʌ k
문턱	m u n tʰ ʌ k
문턱문턱	m u n tʰ ʌ ŋ m u n tʰ ʌ k
물긋물긋	m u ɭ k ɨ n m u ɭ k ɨ t
물끄러미	m u ɭ k͈ ɨ ɭ ʌ m i
물끄럼말끄럼	m u ɭ k͈ ɨ ɭ ʌ m m ɐ ɭ k͈ ɨ ɭ ʌ m
물끄럼물끄럼	m u ɭ k͈ ɨ ɭ ʌ m m u ɭ k͈ ɨ ɭ ʌ m
물덤벙술덤벙	m u ɭ t ʌ m p ʌ ŋ s u ɭ t ʌ m p ʌ ŋ
물렁물렁	m u ɭ ɭ ʌ ŋ m u ɭ ɭ ʌ ŋ
물물	m u ɭ m u ɭ
물씬	m u ɭ s͈ i n
물씬물씬	m u ɭ s͈ i n m u ɭ s͈ i n
물이못나게	m u ɭ i m o n n ɐ k e
물컥	m u ɭ kʰ ʌ k
물컥물컥	m u ɭ kʰ ʌ ŋ m u ɭ kʰ ʌ k
물컹물컹	m u ɭ kʰ ʌ ŋ m u ɭ kʰ ʌ ŋ
물큰	m u ɭ kʰ ɨ n
물큰물큰	m u ɭ kʰ ɨ n m u ɭ kʰ ɨ n
뭉게뭉게	m u ŋ k e m u ŋ k e
뭉그적뭉그적	m u ŋ k ɨ tɕ ʌ ŋ m u ŋ k ɨ tɕ ʌ k
뭉글	m u ŋ k ɨ ɭ
뭉글뭉글	m u ŋ k ɨ ɭ m u ŋ k ɨ ɭ
뭉긋뭉긋	m u ŋ k ɨ n m u ŋ k ɨ t
뭉떵	m u ŋ t͈ ʌ ŋ
뭉떵뭉떵	m u ŋ t͈ ʌ ŋ m u ŋ t͈ ʌ ŋ
뭉뚝	m u ŋ t͈ u k
뭉뚝뭉뚝	m u ŋ t͈ u ŋ m u ŋ t͈ u k
뭉실	m u ŋ s i ɭ
뭉실뭉실	m u ŋ s i ɭ m u ŋ s i ɭ
뭉클	m u ŋ kʰ ɨ ɭ
뭉클뭉클	m u ŋ kʰ ɨ ɭ m u ŋ kʰ ɨ ɭ
뭉텅	m u ŋ tʰ ʌ ŋ
뭉텅뭉텅	m u ŋ tʰ ʌ ŋ m u ŋ tʰ ʌ ŋ
뭉툭	m u ŋ tʰ u k
뭉툭뭉툭	m u ŋ tʰ u ŋ m u ŋ tʰ u k
미끄덩미끄덩	m i k͈ ɨ t ʌ ŋ m i k͈ ɨ t ʌ ŋ
미끈둥미끈둥	m i k͈ ɨ n t u ŋ m i k͈ ɨ n t u ŋ
미끈미끈	m i k͈ ɨ n m i k͈ ɨ n
미끌미끌	m i k͈ ɨ ɭ m i k͈ ɨ ɭ
미루적미루적	m i ɭ u tɕ ʌ ŋ m i ɭ u tɕ ʌ k
미룸미룸	m i ɭ u m m i ɭ u m
미식미식	m i s i ŋ m i s i k
미적미적	m i tɕ ʌ ŋ m i tɕ ʌ k
민둥민둥	m i n t u ŋ m i n t u ŋ
민숭민숭	m i n s u ŋ m i n s u ŋ
밀룽	m i ɭ ɭ u ŋ
밀룽밀룽	m i ɭ ɭ u ŋ m i ɭ ɭ u ŋ
밀치락달치락	m i ɭ tɕʰ i ɭ ɐ k t͈ ɐ ɭ tɕʰ i ɭ ɐ k
바가닥	p ɐ k ɐ t ɐ k
바가닥바가닥	p ɐ k ɐ t ɐ k p͈ ɐ k ɐ t ɐ k
바각	p ɐ k ɐ k
바각바각	p ɐ k ɐ k p͈ ɐ k ɐ k
바그르르	p ɐ k ɨ ɭ ɨ ɭ ɨ
바글바글	p ɐ k ɨ ɭ p ɐ k ɨ ɭ
바동바동	p ɐ t o ŋ p ɐ t o ŋ
바둥바둥	p ɐ t u ŋ p ɐ t u ŋ
바드득	p ɐ t ɨ t ɨ k
바드득바드득	p ɐ t ɨ t ɨ k p͈ ɐ t ɨ t ɨ k
바드등	p ɐ t ɨ t ɨ ŋ
바드등바드등	p ɐ t ɨ t ɨ ŋ p ɐ t ɨ t ɨ ŋ
바득바득	p ɐ t ɨ k p͈ ɐ t ɨ k
바들바들	p ɐ t ɨ ɭ p ɐ t ɨ ɭ
바락	p ɐ ɭ ɐ k
바락바락	p ɐ ɭ ɐ k p͈ ɐ ɭ ɐ k
바람만바람만	p ɐ ɭ ɐ m m ɐ n p ɐ ɭ ɐ m m ɐ n
바르르	p ɐ ɭ ɨ ɭ ɨ
바르작바르작	p ɐ ɭ ɨ tɕ ɐ k p͈ ɐ ɭ ɨ tɕ ɐ k
바리바리	p ɐ ɭ i p ɐ ɭ i
바삭	p ɐ s ɐ k
바삭바삭	p ɐ s ɐ k p͈ ɐ s ɐ k
바스락	p ɐ s ɨ ɭ ɐ k
바스락바스락	p ɐ s ɨ ɭ ɐ k p͈ ɐ s ɨ ɭ ɐ k
바스스	p ɐ s ɨ s ɨ
바슬바슬	p ɐ s ɨ ɭ p ɐ s ɨ ɭ
바시랑바시랑	p ɐ s i ɭ ɐ ŋ p ɐ s i ɭ ɐ ŋ
바싹	p ɐ s͈ ɐ k
바싹바싹	p ɐ s͈ ɐ k p͈ ɐ s͈ ɐ k
바작바작	p ɐ tɕ ɐ k p͈ ɐ tɕ ɐ k
바지지	p ɐ tɕ i tɕ i
바지직	p ɐ tɕ i tɕ i k
바지직바지직	p ɐ tɕ i tɕ i k p͈ ɐ tɕ i tɕ i k
바질바질	p ɐ tɕ i ɭ p ɐ tɕ i ɭ
바짝	p ɐ tɕ͈ ɐ k
바짝바짝	p ɐ tɕ͈ ɐ k p͈ ɐ tɕ͈ ɐ k
박	p ɐ k
박박	p ɐ k p͈ ɐ k
박신박신	p ɐ k s͈ i n p ɐ k s͈ i n
박작	p ɐ k tɕ͈ ɐ k
박작박작	p ɐ k tɕ͈ ɐ k p͈ ɐ k tɕ͈ ɐ k
반둥건둥	p ɐ n t u ŋ k ʌ n t u ŋ
반둥반둥	p ɐ n t u ŋ p ɐ n t u ŋ
반드르르	p ɐ n t ɨ ɭ ɨ ɭ ɨ
반득	p ɐ n t ɨ k
반득반득	p ɐ n t ɨ k p͈ ɐ n t ɨ k
반들반들	p ɐ n t ɨ ɭ p ɐ n t ɨ ɭ
반듯반듯	p ɐ n t ɨ t p͈ ɐ n t ɨ t
반뜩	p ɐ n t͈ ɨ k
반뜩반뜩	p ɐ n t͈ ɨ k p͈ ɐ n t͈ ɨ k
반뜻	p ɐ n t͈ ɨ t
반뜻반뜻	p ɐ n t͈ ɨ t p͈ ɐ n t͈ ɨ t
반송반송	p ɐ n s o ŋ p ɐ n s o ŋ
반작	p ɐ n tɕ ɐ k
반작반작	p ɐ n tɕ ɐ k p͈ ɐ n tɕ ɐ k
반지레	p ɐ n tɕ i ɭ e
반지르르	p ɐ n tɕ i ɭ ɨ ɭ ɨ
반질반질	p ɐ n tɕ i ɭ p ɐ n tɕ i ɭ
반짝	p ɐ n tɕ͈ ɐ k
반짝반짝	p ɐ n tɕ͈ ɐ k p͈ ɐ n tɕ͈ ɐ k
발그레	p ɐ ɭ k ɨ ɭ e
발긋발긋	p ɐ ɭ k ɨ t p͈ ɐ ɭ k ɨ t
발기발기	p ɐ ɭ k i p ɐ ɭ k i
발깍	p ɐ ɭ k͈ ɐ k
발깍발깍	p ɐ ɭ k͈ ɐ k p͈ ɐ ɭ k͈ ɐ k
발끈	p ɐ ɭ k͈ ɨ n
발끈발끈	p ɐ ɭ k͈ ɨ n p ɐ ɭ k͈ ɨ n
발딱	p ɐ ɭ t͈ ɐ k
발딱발딱	p ɐ ɭ t͈ ɐ k p͈ ɐ ɭ t͈ ɐ k
발라당	p ɐ ɭ ɭ ɐ t ɐ ŋ
발라당발라당	p ɐ ɭ ɭ ɐ t ɐ ŋ p ɐ ɭ ɭ ɐ t ɐ ŋ
발랑	p ɐ ɭ ɭ ɐ ŋ
발랑발랑	p ɐ ɭ ɭ ɐ ŋ p ɐ ɭ ɭ ɐ ŋ
발록	p ɐ ɭ ɭ o k
발록발록	p ɐ ɭ ɭ o k p͈ ɐ ɭ ɭ o k
발롱발롱	p ɐ ɭ ɭ o ŋ p ɐ ɭ ɭ o ŋ
발룽발룽	p ɐ ɭ ɭ u ŋ p ɐ ɭ ɭ u ŋ
발름	p ɐ ɭ ɭ ɨ m
발름발름	p ɐ ɭ ɭ ɨ m p ɐ ɭ ɭ ɨ m
발맘발맘	p ɐ ɭ m ɐ m p ɐ ɭ m ɐ m
발바투	p ɐ ɭ p ɐ tʰ u
발발	p ɐ ɭ p ɐ ɭ
발밤발밤	p ɐ ɭ p ɐ m p ɐ ɭ p ɐ m
발씬	p ɐ ɭ s͈ i n
발씬발씬	p ɐ ɭ s͈ i n p ɐ ɭ s͈ i n
발짝발짝	p ɐ ɭ tɕ͈ ɐ k p͈ ɐ ɭ tɕ͈ ɐ k
발쪽	p ɐ ɭ tɕ͈ o k
발쪽발쪽	p ɐ ɭ tɕ͈ o k p͈ ɐ ɭ tɕ͈ o k
발칵	p ɐ ɭ kʰ ɐ k
발칵발칵	p ɐ ɭ kʰ ɐ k p͈ ɐ ɭ kʰ ɐ k
방그레	p ɐ ŋ k ɨ ɭ e
방글	p ɐ ŋ k ɨ ɭ
방글방글	p ɐ ŋ k ɨ ɭ p ɐ ŋ k ɨ ɭ
방긋	p ɐ ŋ k ɨ t
방긋방긋	p ɐ ŋ k ɨ t p͈ ɐ ŋ k ɨ t
방끗	p ɐ ŋ k͈ ɨ t
방끗방끗	p ɐ ŋ k͈ ɨ t p͈ ɐ ŋ k͈ ɨ t
방방	p ɐ ŋ p ɐ ŋ
방시레	p ɐ ŋ s i ɭ e
방실	p ɐ ŋ s i ɭ
방실방실	p ɐ ŋ s i ɭ p ɐ ŋ s i ɭ
방싯	p ɐ ŋ s i t
방싯방싯	p ɐ ŋ s i t p͈ ɐ ŋ s i t
배가닥	p ɛ k ɐ t ɐ k
배가닥배가닥	p ɛ k ɐ t ɐ k p͈ ɛ k ɐ t ɐ k
배끗	p ɛ k͈ ɨ t
배끗배끗	p ɛ k͈ ɨ t p͈ ɛ k͈ ɨ t
배딱배딱	p ɛ t͈ ɐ k p͈ ɛ t͈ ɐ k
배뚝배뚝	p ɛ t͈ u k p͈ ɛ t͈ u k
배뚤배뚤	p ɛ t͈ u ɭ p ɛ t͈ u ɭ
배리배리	p ɛ ɭ i p ɛ ɭ i
배릿배릿	p ɛ ɭ i t p͈ ɛ ɭ i t
배배	p ɛ p ɛ
배뱅글	p ɛ p ɛ ŋ k ɨ ɭ
배슥배슥	p ɛ s ɨ k p͈ ɛ s ɨ k
배슬배슬	p ɛ s ɨ ɭ p ɛ s ɨ ɭ
배시시	p ɛ s i s i
배식배식	p ɛ s i k p͈ ɛ s i k
배싹	p ɛ s͈ ɐ k
배싹배싹	p ɛ s͈ ɐ k p͈ ɛ s͈ ɐ k
배쓱	p ɛ s͈ ɨ k
배쓱배쓱	p ɛ s͈ ɨ k p͈ ɛ s͈ ɨ k
배죽	p ɛ tɕ u k
배죽배죽	p ɛ tɕ u k p͈ ɛ tɕ u k
배짝	p ɛ tɕ͈ ɐ k
배짝배짝	p ɛ tɕ͈ ɐ k p͈ ɛ tɕ͈ ɐ k
배쫑배쫑	p ɛ tɕ͈ o ŋ p ɛ tɕ͈ o ŋ
배쭉	p ɛ tɕ͈ u k
배쭉배쭉	p ɛ tɕ͈ u k p͈ ɛ tɕ͈ u k
배치작배치작	p ɛ tɕʰ i tɕ ɐ k p͈ ɛ tɕʰ i tɕ ɐ k
배칠배칠	p ɛ tɕʰ i ɭ p ɛ tɕʰ i ɭ
배트작배트작	p ɛ tʰ ɨ tɕ ɐ k p͈ ɛ tʰ ɨ tɕ ɐ k
배틀	p ɛ tʰ ɨ ɭ
배틀배틀	p ɛ tʰ ɨ ɭ p ɛ tʰ ɨ ɭ
밴둥밴둥	p ɛ n t u ŋ p ɛ n t u ŋ
밴들밴들	p ɛ n t ɨ ɭ p ɛ n t ɨ ɭ
뱅	p ɛ ŋ
뱅그레	p ɛ ŋ k ɨ ɭ e
뱅그르르	p ɛ ŋ k ɨ ɭ ɨ ɭ ɨ
뱅글	p ɛ ŋ k ɨ ɭ
뱅글뱅글	p ɛ ŋ k ɨ ɭ p ɛ ŋ k ɨ ɭ
뱅긋	p ɛ ŋ k ɨ t
뱅긋뱅긋	p ɛ ŋ k ɨ t p͈ ɛ ŋ k ɨ t
뱅끗	p ɛ ŋ k͈ ɨ t
뱅끗뱅끗	p ɛ ŋ k͈ ɨ t p͈ ɛ ŋ k͈ ɨ t
뱅뱅	p ɛ ŋ p ɛ ŋ
뱅시레	p ɛ ŋ s i ɭ e
뱅실	p ɛ ŋ s i ɭ
뱅실뱅실	p ɛ ŋ s i ɭ p ɛ ŋ s i ɭ
뱅싯	p ɛ ŋ s i t
뱅싯뱅싯	p ɛ ŋ s i t p͈ ɛ ŋ s i t
뱌비작뱌비작	p j ɐ p i tɕ ɐ k p͈ j ɐ p i tɕ ɐ k
뱌슬뱌슬	p j ɐ s ɨ ɭ p j ɐ s ɨ ɭ
뱐미주룩	p j ɐ n m i tɕ u ɭ u k
뱐죽뱐죽	p j ɐ n tɕ u k p͈ j ɐ n tɕ u k
버거덕	p ʌ k ʌ t ʌ k
버거덕버거덕	p ʌ k ʌ t ʌ k p͈ ʌ k ʌ t ʌ k
버걱	p ʌ k ʌ k
버걱버걱	p ʌ k ʌ k p͈ ʌ k ʌ k
버그르르	p ʌ k ɨ ɭ ɨ ɭ ɨ
버근버근	p ʌ k ɨ n p ʌ k ɨ n
버글버글	p ʌ k ɨ ɭ p ʌ k ɨ ɭ
버둥버둥	p ʌ t u ŋ p ʌ t u ŋ
버들버들	p ʌ t ɨ ɭ p ʌ t ɨ ɭ
버럭	p ʌ ɭ ʌ k
버럭버럭	p ʌ ɭ ʌ k p͈ ʌ ɭ ʌ k
버르르	p ʌ ɭ ɨ ɭ ɨ
버르적버르적	p ʌ ɭ ɨ tɕ ʌ k p͈ ʌ ɭ ɨ tɕ ʌ k
버름버름	p ʌ ɭ ɨ m p ʌ ɭ ɨ m
버석	p ʌ s ʌ k
버석버석	p ʌ s ʌ k p͈ ʌ s ʌ k
버스럭	p ʌ s ɨ ɭ ʌ k
버스럭버스럭	p ʌ s ɨ ɭ ʌ k p͈ ʌ s ɨ ɭ ʌ k
버슬버슬	p ʌ s ɨ ɭ p ʌ s ɨ ɭ
버썩	p ʌ s͈ ʌ k
버썩버썩	p ʌ s͈ ʌ k p͈ ʌ s͈ ʌ k
버적버적	p ʌ tɕ ʌ k p͈ ʌ tɕ ʌ k
버쩍	p ʌ tɕ͈ ʌ k
버쩍버쩍	p ʌ tɕ͈ ʌ k p͈ ʌ tɕ͈ ʌ k
벅	p ʌ k
벅벅	p ʌ k p͈ ʌ k
벅신벅신	p ʌ k s͈ i n p ʌ k s͈ i n
벅적	p ʌ k tɕ͈ ʌ k
벅적벅적	p ʌ k tɕ͈ ʌ k p͈ ʌ k tɕ͈ ʌ k
번둥번둥	p ʌ n t u ŋ p ʌ n t u ŋ
번드르르	p ʌ n t ɨ ɭ ɨ ɭ ɨ
번득	p ʌ n t ɨ k
번득번득	p ʌ n t ɨ k p͈ ʌ n t ɨ k
번들번들	p ʌ n t ɨ ɭ p ʌ n t ɨ ɭ
번듯번듯	p ʌ n t ɨ t p͈ ʌ n t ɨ t
번뜩	p ʌ n t͈ ɨ k
번뜩번뜩	p ʌ n t͈ ɨ k p͈ ʌ n t͈ ɨ k
번뜻	p ʌ n t͈ ɨ t
번뜻번뜻	p ʌ n t͈ ɨ t p͈ ʌ n t͈ ɨ t
번적	p ʌ n tɕ ʌ k
번적번적	p ʌ n tɕ ʌ k p͈ ʌ n tɕ ʌ k
번죽번죽	p ʌ n tɕ u k p͈ ʌ n tɕ u k
번지레	p ʌ n tɕ i ɭ e
번지르르	p ʌ n tɕ i ɭ ɨ ɭ ɨ
번질번질	p ʌ n tɕ i ɭ p ʌ n tɕ i ɭ
번쩍	p ʌ n tɕ͈ ʌ k
번쩍번쩍	p ʌ n tɕ͈ ʌ k p͈ ʌ n tɕ͈ ʌ k
벌그레	p ʌ ɭ k ɨ ɭ e
벌긋벌긋	p ʌ ɭ k ɨ t p͈ ʌ ɭ k ɨ t
벌꺽	p ʌ ɭ k͈ ʌ k
벌꺽벌꺽	p ʌ ɭ k͈ ʌ k p͈ ʌ ɭ k͈ ʌ k
벌끈	p ʌ ɭ k͈ ɨ n
벌끈벌끈	p ʌ ɭ k͈ ɨ n p ʌ ɭ k͈ ɨ n
벌떠덕	p ʌ ɭ t͈ ʌ t ʌ k
벌떡	p ʌ ɭ t͈ ʌ k
벌떡벌떡	p ʌ ɭ t͈ ʌ k p͈ ʌ ɭ t͈ ʌ k
벌러덩	p ʌ ɭ ɭ ʌ t ʌ ŋ
벌러덩벌러덩	p ʌ ɭ ɭ ʌ t ʌ ŋ p ʌ ɭ ɭ ʌ t ʌ ŋ
벌렁벌렁	p ʌ ɭ ɭ ʌ ŋ p ʌ ɭ ɭ ʌ ŋ
벌룩	p ʌ ɭ ɭ u k
벌룩벌룩	p ʌ ɭ ɭ u k p͈ ʌ ɭ ɭ u k
벌룽벌룽	p ʌ ɭ ɭ u ŋ p ʌ ɭ ɭ u ŋ
벌름	p ʌ ɭ ɭ ɨ m
벌름벌름	p ʌ ɭ ɭ ɨ m p ʌ ɭ ɭ ɨ m
벌벌	p ʌ ɭ p ʌ ɭ
벌씬	p ʌ ɭ s͈ i n
벌씬벌씬	p ʌ ɭ s͈ i n p ʌ ɭ s͈ i n
벌씸벌씸	p ʌ ɭ s͈ i m p ʌ ɭ s͈ i m
벌쩍벌쩍	p ʌ ɭ tɕ͈ ʌ k p͈ ʌ ɭ tɕ͈ ʌ k
벌쭉	p ʌ ɭ tɕ͈ u k
벌쭉벌쭉	p ʌ ɭ tɕ͈ u k p͈ ʌ ɭ tɕ͈ u k
벌컥	p ʌ ɭ kʰ ʌ k
벌컥벌컥	p ʌ ɭ kʰ ʌ k p͈ ʌ ɭ kʰ ʌ k
벌큼벌큼	p ʌ ɭ kʰ ɨ m p ʌ ɭ kʰ ɨ m
법석법석	p ʌ p s͈ ʌ k p͈ ʌ p s͈ ʌ k
벙그레	p ʌ ŋ k ɨ ɭ e
벙글	p ʌ ŋ k ɨ ɭ
벙글벙글	p ʌ ŋ k ɨ ɭ p ʌ ŋ k ɨ ɭ
벙긋	p ʌ ŋ k ɨ t
벙긋벙긋	p ʌ ŋ k ɨ t p͈ ʌ ŋ k ɨ t
벙끗	p ʌ ŋ k͈ ɨ t
벙끗벙끗	p ʌ ŋ k͈ ɨ t p͈ ʌ ŋ k͈ ɨ t
벙시레	p ʌ ŋ s i ɭ e
벙실	p ʌ ŋ s i ɭ
벙실벙실	p ʌ ŋ s i ɭ p ʌ ŋ s i ɭ
벙싯	p ʌ ŋ s i t
벙싯벙싯	p ʌ ŋ s i t p͈ ʌ ŋ s i t
베슥베슥	p e s ɨ k p͈ e s ɨ k
베슬베슬	p e s ɨ ɭ p e s ɨ ɭ
베짱베짱	p e tɕ͈ ɐ ŋ p e tɕ͈ ɐ ŋ
벼름벼름	p j ʌ ɭ ɨ m p j ʌ ɭ ɨ m
보각	p o k ɐ k
보각보각	p o k ɐ k p͈ o k ɐ k
보그르르	p o k ɨ ɭ ɨ ɭ ɨ
보글보글	p o k ɨ ɭ p o k ɨ ɭ
보도독	p o t o t o k
보도독보도독	p o t o t o k p͈ o t o t o k
보독보독	p o t o k p͈ o t o k
보동보동	p o t o ŋ p o t o ŋ
보드득	p o t ɨ t ɨ k
보드득보드득	p o t ɨ t ɨ k p͈ o t ɨ t ɨ k
보드등	p o t ɨ t ɨ ŋ
보드등보드등	p o t ɨ t ɨ ŋ p o t ɨ t ɨ ŋ
보들보들	p o t ɨ ɭ p o t ɨ ɭ
보르르	p o ɭ ɨ ɭ ɨ
보삭	p o s ɐ k
보삭보삭	p o s ɐ k p͈ o s ɐ k
보송보송	p o s o ŋ p o s o ŋ
보스락	p o s ɨ ɭ ɐ k
보스락보스락	p o s ɨ ɭ ɐ k p͈ o s ɨ ɭ ɐ k
보스스	p o s ɨ s ɨ
보슬보슬	p o s ɨ ɭ p o s ɨ ɭ
보싹	p o s͈ ɐ k
보싹보싹	p o s͈ ɐ k p͈ o s͈ ɐ k
보풀보풀	p o pʰ u ɭ p o pʰ u ɭ
복	p o k
복닥복닥	p o k t͈ ɐ k p͈ o k t͈ ɐ k
복복	p o k p͈ o k
복슬복슬	p o k s͈ ɨ ɭ p o k s͈ ɨ ɭ
복작	p o k tɕ͈ ɐ k
복작복작	p o k tɕ͈ ɐ k p͈ o k tɕ͈ ɐ k
본숭만숭	p o n s u ŋ m ɐ n s u ŋ
볼각볼각	p o ɭ k ɐ k p͈ o ɭ k ɐ k
볼강볼강	p o ɭ k ɐ ŋ p o ɭ k ɐ ŋ
볼그레	p o ɭ k ɨ ɭ e
볼그스레	p o ɭ k ɨ s ɨ ɭ e
볼근볼근	p o ɭ k ɨ n p o ɭ k ɨ n
볼긋볼긋	p o ɭ k ɨ t p͈ o ɭ k ɨ t
볼끈	p o ɭ k͈ ɨ n
볼끈볼끈	p o ɭ k͈ ɨ n p o ɭ k͈ ɨ n
볼똑	p o ɭ t͈ o k
볼똑볼똑	p o ɭ t͈ o k p͈ o ɭ t͈ o k
볼똥볼똥	p o ɭ t͈ o ŋ p o ɭ t͈ o ŋ
볼록	p o ɭ ɭ o k
볼록볼록	p o ɭ ɭ o k p͈ o ɭ ɭ o k
볼만장만	p o ɭ m ɐ n tɕ ɐ ŋ m ɐ n
볼쏙	p o ɭ s͈ o k
볼쏙볼쏙	p o ɭ s͈ o k p͈ o ɭ s͈ o k
볼칵	p o ɭ kʰ ɐ k
볼칵볼칵	p o ɭ kʰ ɐ k p͈ o ɭ kʰ ɐ k
볼통볼통	p o ɭ tʰ o ŋ p o ɭ tʰ o ŋ
봉	p o ŋ
봉곳	p o ŋ k o t
봉곳봉곳	p o ŋ k o t p͈ o ŋ k o t
봉긋	p o ŋ k ɨ t
봉긋봉긋	p o ŋ k ɨ t p͈ o ŋ k ɨ t
봉봉	p o ŋ p o ŋ
봉실	p o ŋ s i ɭ
봉실봉실	p o ŋ s i ɭ p o ŋ s i ɭ
봉싯	p o ŋ s i t
봉싯봉싯	p o ŋ s i t p͈ o ŋ s i t
부	p u
부걱	p u k ʌ k
부걱부걱	p u k ʌ k p͈ u k ʌ k
부그르르	p u k ɨ ɭ ɨ ɭ ɨ
부글부글	p u k ɨ ɭ p u k ɨ ɭ
부두둑	p u t u t u k
부두둑부두둑	p u t u t u k p͈ u t u t u k
부둑부둑	p u t u k p͈ u t u k
부둥부둥	p u t u ŋ p u t u ŋ
부드득	p u t ɨ t ɨ k
부드득부드득	p u t ɨ t ɨ k p͈ u t ɨ t ɨ k
부드등	p u t ɨ t ɨ ŋ
부드등부드등	p u t ɨ t ɨ ŋ p u t ɨ t ɨ ŋ
부득부득	p u t ɨ k p͈ u t ɨ k
부들부들	p u t ɨ ɭ p u t ɨ ɭ
부등부등	p u t ɨ ŋ p u t ɨ ŋ
부랴부랴	p u ɭ j ɐ p u ɭ j ɐ
부랴사랴	p u ɭ j ɐ s ɐ ɭ j ɐ
부르르	p u ɭ ɨ ɭ ɨ
부르릉	p u ɭ ɨ ɭ ɨ ŋ
부르릉부르릉	p u ɭ ɨ ɭ ɨ ŋ p u ɭ ɨ ɭ ɨ ŋ
부리부리	p u ɭ i p u ɭ i
부부	p u p u
부석	p u s ʌ k
부석부석	p u s ʌ k p͈ u s ʌ k
부숭부숭	p u s u ŋ p u s u ŋ
부스럭	p u s ɨ ɭ ʌ k
부스럭부스럭	p u s ɨ ɭ ʌ k p͈ u s ɨ ɭ ʌ k
부스스	p u s ɨ s ɨ
부슬부슬	p u s ɨ ɭ p u s ɨ ɭ
부썩	p u s͈ ʌ k
부썩부썩	p u s͈ ʌ k p͈ u s͈ ʌ k
부얼부얼	p u ʌ ɭ p u ʌ ɭ
부엉	p u ʌ ŋ
부엉부엉	p u ʌ ŋ p u ʌ ŋ
부웅부웅	p u u ŋ p u u ŋ
부전부전	p u tɕ ʌ n p u tɕ ʌ n
부지지	p u tɕ i tɕ i
부지직	p u tɕ i tɕ i k
부지직부지직	p u tɕ i tɕ i k p͈ u tɕ i tɕ i k
부질부질	p u tɕ i ɭ p u tɕ i ɭ
부쩍	p u tɕ͈ ʌ k
부쩍부쩍	p u tɕ͈ ʌ k p͈ u tɕ͈ ʌ k
부풀부풀	p u pʰ u ɭ p u pʰ u ɭ
부픗부픗	p u pʰ ɨ t p͈ u pʰ ɨ t
북	p u k
북덕북덕	p u k t͈ ʌ k p͈ u k t͈ ʌ k
북북	p u k p͈ u k
북슬북슬	p u k s͈ ɨ ɭ p u k s͈ ɨ ɭ
북실북실	p u k s͈ i ɭ p u k s͈ i ɭ
북적	p u k tɕ͈ ʌ k
북적북적	p u k tɕ͈ ʌ k p͈ u k tɕ͈ ʌ k
불걱불걱	p u ɭ k ʌ k p͈ u ɭ k ʌ k
불겅불겅	p u ɭ k ʌ ŋ p u ɭ k ʌ ŋ
불그레	p u ɭ k ɨ ɭ e
불그스레	p u ɭ k ɨ s ɨ ɭ e
불근불근	p u ɭ k ɨ n p u ɭ k ɨ n
불긋불긋	p u ɭ k ɨ t p͈ u ɭ k ɨ t
불끈	p u ɭ k͈ ɨ n
불끈불끈	p u ɭ k͈ ɨ n p u ɭ k͈ ɨ n
불뚝	p u ɭ t͈ u k
불뚝불뚝	p u ɭ t͈ u k p͈ u ɭ t͈ u k
불뚱불뚱	p u ɭ t͈ u ŋ p u ɭ t͈ u ŋ
불룩	p u ɭ ɭ u k
불룩불룩	p u ɭ ɭ u k p͈ u ɭ ɭ u k
불불불	p u ɭ p u ɭ p u ɭ
불쑥	p u ɭ s͈ u k
불쑥불쑥	p u ɭ s͈ u k p͈ u ɭ s͈ u k
불쩍불쩍	p u ɭ tɕ͈ ʌ k p͈ u ɭ tɕ͈ ʌ k
불컥	p u ɭ kʰ ʌ k
불컥불컥	p u ɭ kʰ ʌ k p͈ u ɭ kʰ ʌ k
불퉁불퉁	p u ɭ tʰ u ŋ p u ɭ tʰ u ŋ
불풍나게	p u ɭ pʰ u ŋ n ɐ k e
불현듯	p u ɭ j ʌ n t ɨ t
불현듯이	p u ɭ j ʌ n t ɨ s i
붉으락푸르락	p u ɭ k ɨ ɭ ɐ k pʰ u ɭ ɨ ɭ ɐ k
붐빠붐빠	p u m p͈ ɐ p u m p͈ ɐ
붕	p u ŋ
붕긋	p u ŋ k ɨ t
붕긋붕긋	p u ŋ k ɨ t p͈ u ŋ k ɨ t
붕붕	p u ŋ p u ŋ
비거걱	p i k ʌ k ʌ k
비거덕	p i k ʌ t ʌ k
비거덕비거덕	p i k ʌ t ʌ k p͈ i k ʌ t ʌ k
비걱배각	p i k ʌ k p͈ ɛ k ɐ k
비근비근	p i k ɨ n p i k ɨ n
비금비금	p i k ɨ m p i k ɨ m
비끗	p i k͈ ɨ t
비끗비끗	p i k͈ ɨ t p͈ i k͈ ɨ t
비딱비딱	p i t͈ ɐ k p͈ i t͈ ɐ k
비뚝비뚝	p i t͈ u k p͈ i t͈ u k
비뚤배뚤	p i t͈ u ɭ p ɛ t͈ u ɭ
비뚤비뚤	p i t͈ u ɭ p i t͈ u ɭ
비리비리	p i ɭ i p i ɭ i
비릿비릿	p i ɭ i t p͈ i ɭ i t
비비	p i p i
비비배배	p i p i p ɛ p ɛ
비비적비비적	p i p i tɕ ʌ k p͈ i p i tɕ ʌ k
비슥비슥	p i s ɨ k p͈ i s ɨ k
비슬비슬	p i s ɨ ɭ p i s ɨ ɭ
비슷비슷	p i s ɨ t p͈ i s ɨ t
비식비식	p i s i k p͈ i s i k
비실비실	p i s i ɭ p i s i ɭ
비썩	p i s͈ ʌ k
비썩비썩	p i s͈ ʌ k p͈ i s͈ ʌ k
비쓱비쓱	p i s͈ ɨ k p͈ i s͈ ɨ k
비쓸비쓸	p i s͈ ɨ ɭ p i s͈ ɨ ɭ
비악	p i ɐ k
비악비악	p i ɐ k p͈ i ɐ k
비영비영	p i j ʌ ŋ p i j ʌ ŋ
비오	p i o
비오비오	p i o p i o
비적비적	p i tɕ ʌ k p͈ i tɕ ʌ k
비죽	p i tɕ u k
비죽배죽	p i tɕ u k p͈ ɛ tɕ u k
비죽비죽	p i tɕ u k p͈ i tɕ u k
비줄비줄	p i tɕ u ɭ p i tɕ u ɭ
비쩍	p i tɕ͈ ʌ k
비쩍비쩍	p i tɕ͈ ʌ k p͈ i tɕ͈ ʌ k
비쭉	p i tɕ͈ u k
비쭉배쭉	p i tɕ͈ u k p͈ ɛ tɕ͈ u k
비쭉비쭉	p i tɕ͈ u k p͈ i tɕ͈ u k
비치적비치적	p i tɕʰ i tɕ ʌ k p͈ i tɕʰ i tɕ ʌ k
비칠비칠	p i tɕʰ i ɭ p i tɕʰ i ɭ
비트적비트적	p i tʰ ɨ tɕ ʌ k p͈ i tʰ ɨ tɕ ʌ k
비틀	p i tʰ ɨ ɭ
비틀비틀	p i tʰ ɨ ɭ p i tʰ ɨ ɭ
빈둥빈둥	p i n t u ŋ p i n t u ŋ
빈들빈들	p i n t ɨ ɭ p i n t ɨ ɭ
빈미주룩	p i n m i tɕ u ɭ u k
빈정빈정	p i n tɕ ʌ ŋ p i n tɕ ʌ ŋ
빌빌	p i ɭ p i ɭ
빙	p i ŋ
빙그레	p i ŋ k ɨ ɭ e
빙그르	p i ŋ k ɨ ɭ ɨ
빙그르르	p i ŋ k ɨ ɭ ɨ ɭ ɨ
빙글	p i ŋ k ɨ ɭ
빙글빙글	p i ŋ k ɨ ɭ p i ŋ k ɨ ɭ
빙긋	p i ŋ k ɨ t
빙긋빙긋	p i ŋ k ɨ t p͈ i ŋ k ɨ t
빙깃빙깃	p i ŋ k i t p͈ i ŋ k i t
빙끗	p i ŋ k͈ ɨ t
빙끗빙끗	p i ŋ k͈ ɨ t p͈ i ŋ k͈ ɨ t
빙빙	p i ŋ p i ŋ
빙시레	p i ŋ s i ɭ e
빙실	p i ŋ s i ɭ
빙실빙실	p i ŋ s i ɭ p i ŋ s i ɭ
빙싯	p i ŋ s i t
빙싯빙싯	p i ŋ s i t p͈ i ŋ s i t
빠가닥	p͈ ɐ k ɐ t ɐ k
빠가닥빠가닥	p͈ ɐ k ɐ t ɐ k p͈ ɐ k ɐ t ɐ k
빠각	p͈ ɐ k ɐ k
빠각빠각	p͈ ɐ k ɐ k p͈ ɐ k ɐ k
빠그르르	p͈ ɐ k ɨ ɭ ɨ ɭ ɨ
빠글빠글	p͈ ɐ k ɨ ɭ p͈ ɐ k ɨ ɭ
빠금	p͈ ɐ k ɨ m
빠금빠금	p͈ ɐ k ɨ m p͈ ɐ k ɨ m
빠까닥	p͈ ɐ k͈ ɐ t ɐ k
빠까닥빠까닥	p͈ ɐ k͈ ɐ t ɐ k p͈ ɐ k͈ ɐ t ɐ k
빠깍	p͈ ɐ k͈ ɐ k
빠깍빠깍	p͈ ɐ k͈ ɐ k p͈ ɐ k͈ ɐ k
빠끔	p͈ ɐ k͈ ɨ m
빠끔빠끔	p͈ ɐ k͈ ɨ m p͈ ɐ k͈ ɨ m
빠닥빠닥	p͈ ɐ t ɐ k p͈ ɐ t ɐ k
빠드득	p͈ ɐ t ɨ t ɨ k
빠드득빠드득	p͈ ɐ t ɨ t ɨ k p͈ ɐ t ɨ t ɨ k
빠드등	p͈ ɐ t ɨ t ɨ ŋ
빠드등빠드등	p͈ ɐ t ɨ t ɨ ŋ p͈ ɐ t ɨ t ɨ ŋ
빠득빠득	p͈ ɐ t ɨ k p͈ ɐ t ɨ k
빠르작빠르작	p͈ ɐ ɭ ɨ tɕ ɐ k p͈ ɐ ɭ ɨ tɕ ɐ k
빠삭	p͈ ɐ s ɐ k
빠삭빠삭	p͈ ɐ s ɐ k p͈ ɐ s ɐ k
빠스락	p͈ ɐ s ɨ ɭ ɐ k
빠스락빠스락	p͈ ɐ s ɨ ɭ ɐ k p͈ ɐ s ɨ ɭ ɐ k
빠작빠작	p͈ ɐ tɕ ɐ k p͈ ɐ tɕ ɐ k
빠지지	p͈ ɐ tɕ i tɕ i
빠지직	p͈ ɐ tɕ i tɕ i k
빠지직빠지직	p͈ ɐ tɕ i tɕ i k p͈ ɐ tɕ i tɕ i k
빠질빠질	p͈ ɐ tɕ i ɭ p͈ ɐ tɕ i ɭ
빠짝	p͈ ɐ tɕ͈ ɐ k
빠짝빠짝	p͈ ɐ tɕ͈ ɐ k p͈ ɐ tɕ͈ ɐ k
빡	p͈ ɐ k
빡빡	p͈ ɐ k p͈ ɐ k
빤둥빤둥	p͈ ɐ n t u ŋ p͈ ɐ n t u ŋ
빤드르르	p͈ ɐ n t ɨ ɭ ɨ ɭ ɨ
빤득	p͈ ɐ n t ɨ k
빤득빤득	p͈ ɐ n t ɨ k p͈ ɐ n t ɨ k
빤들빤들	p͈ ɐ n t ɨ ɭ p͈ ɐ n t ɨ ɭ
빤뜩	p͈ ɐ n t͈ ɨ k
빤뜩빤뜩	p͈ ɐ n t͈ ɨ k p͈ ɐ n t͈ ɨ k
빤작	p͈ ɐ n tɕ ɐ k
빤작빤작	p͈ ɐ n tɕ ɐ k p͈ ɐ n tɕ ɐ k
빤지레	p͈ ɐ n tɕ i ɭ e
빤지르르	p͈ ɐ n tɕ i ɭ ɨ ɭ ɨ
빤질빤질	p͈ ɐ n tɕ i ɭ p͈ ɐ n tɕ i ɭ
빤짝	p͈ ɐ n tɕ͈ ɐ k
빤짝빤짝	p͈ ɐ n tɕ͈ ɐ k p͈ ɐ n tɕ͈ ɐ k
빨그레	p͈ ɐ ɭ k ɨ ɭ e
빨긋빨긋	p͈ ɐ ɭ k ɨ t p͈ ɐ ɭ k ɨ t
빨깍	p͈ ɐ ɭ k͈ ɐ k
빨깍빨깍	p͈ ɐ ɭ k͈ ɐ k p͈ ɐ ɭ k͈ ɐ k
빨끈	p͈ ɐ ɭ k͈ ɨ n
빨끈빨끈	p͈ ɐ ɭ k͈ ɨ n p͈ ɐ ɭ k͈ ɨ n
빨딱	p͈ ɐ ɭ t͈ ɐ k
빨딱빨딱	p͈ ɐ ɭ t͈ ɐ k p͈ ɐ ɭ t͈ ɐ k
빨랑빨랑	p͈ ɐ ɭ ɭ ɐ ŋ p͈ ɐ ɭ ɭ ɐ ŋ
빨빨	p͈ ɐ ɭ p͈ ɐ ɭ
빨쪽	p͈ ɐ ɭ tɕ͈ o k
빨쪽빨쪽	p͈ ɐ ɭ tɕ͈ o k p͈ ɐ ɭ tɕ͈ o k
빵	p͈ ɐ ŋ
빵그레	p͈ ɐ ŋ k ɨ ɭ e
빵글	p͈ ɐ ŋ k ɨ ɭ
빵글빵글	p͈ ɐ ŋ k ɨ ɭ p͈ ɐ ŋ k ɨ ɭ
빵긋	p͈ ɐ ŋ k ɨ t
빵긋빵긋	p͈ ɐ ŋ k ɨ t p͈ ɐ ŋ k ɨ t
빵끗	p͈ ɐ ŋ k͈ ɨ t
빵끗빵끗	p͈ ɐ ŋ k͈ ɨ t p͈ ɐ ŋ k͈ ɨ t
빵빵	p͈ ɐ ŋ p͈ ɐ ŋ
빵시레	p͈ ɐ ŋ s i ɭ e
빵실	p͈ ɐ ŋ s i ɭ
빵실빵실	p͈ ɐ ŋ s i ɭ p͈ ɐ ŋ s i ɭ
빵싯	p͈ ɐ ŋ s i t
빵싯빵싯	p͈ ɐ ŋ s i t p͈ ɐ ŋ s i t
빼	p͈ ɛ
빼가닥	p͈ ɛ k ɐ t ɐ k
빼가닥빼가닥	p͈ ɛ k ɐ t ɐ k p͈ ɛ k ɐ t ɐ k
빼곡	p͈ ɛ k o k
빼까닥	p͈ ɛ k͈ ɐ t ɐ k
빼까닥빼까닥	p͈ ɛ k͈ ɐ t ɐ k p͈ ɛ k͈ ɐ t ɐ k
빼꼭	p͈ ɛ k͈ o k
빼꼼	p͈ ɛ k͈ o m
빼끗	p͈ ɛ k͈ ɨ t
빼끗빼끗	p͈ ɛ k͈ ɨ t p͈ ɛ k͈ ɨ t
빼딱빼딱	p͈ ɛ t͈ ɐ k p͈ ɛ t͈ ɐ k
빼뚝빼뚝	p͈ ɛ t͈ u k p͈ ɛ t͈ u k
빼뚤빼뚤	p͈ ɛ t͈ u ɭ p͈ ɛ t͈ u ɭ
빼빼	p͈ ɛ p͈ ɛ
빼족빼족	p͈ ɛ tɕ o k p͈ ɛ tɕ o k
빼죽	p͈ ɛ tɕ u k
빼죽빼죽	p͈ ɛ tɕ u k p͈ ɛ tɕ u k
빼쪽빼쪽	p͈ ɛ tɕ͈ o k p͈ ɛ tɕ͈ o k
빼쭉	p͈ ɛ tɕ͈ u k
빼쭉빼쭉	p͈ ɛ tɕ͈ u k p͈ ɛ tɕ͈ u k
빼트작빼트작	p͈ ɛ tʰ ɨ tɕ ɐ k p͈ ɛ tʰ ɨ tɕ ɐ k
빼틀빼틀	p͈ ɛ tʰ ɨ ɭ p͈ ɛ tʰ ɨ ɭ
빽	p͈ ɛ k
빽빽	p͈ ɛ k p͈ ɛ k
뺀둥뺀둥	p͈ ɛ n t u ŋ p͈ ɛ n t u ŋ
뺀들뺀들	p͈ ɛ n t ɨ ɭ p͈ ɛ n t ɨ ɭ
뺀질뺀질	p͈ ɛ n tɕ i ɭ p͈ ɛ n tɕ i ɭ
뺑	p͈ ɛ ŋ
뺑그레	p͈ ɛ ŋ k ɨ ɭ e
뺑그르르	p͈ ɛ ŋ k ɨ ɭ ɨ ɭ ɨ
뺑글	p͈ ɛ ŋ k ɨ ɭ
뺑글뺑글	p͈ ɛ ŋ k ɨ ɭ p͈ ɛ ŋ k ɨ ɭ
뺑긋	p͈ ɛ ŋ k ɨ t
뺑긋뺑긋	p͈ ɛ ŋ k ɨ t p͈ ɛ ŋ k ɨ t
뺑끗	p͈ ɛ ŋ k͈ ɨ t
뺑끗뺑끗	p͈ ɛ ŋ k͈ ɨ t p͈ ɛ ŋ k͈ ɨ t
뺑뺑	p͈ ɛ ŋ p͈ ɛ ŋ
뺑시레	p͈ ɛ ŋ s i ɭ e
뺑실	p͈ ɛ ŋ s i ɭ
뺑실뺑실	p͈ ɛ ŋ s i ɭ p͈ ɛ ŋ s i ɭ
뺑싯	p͈ ɛ ŋ s i t
뺑싯뺑싯	p͈ ɛ ŋ s i t p͈ ɛ ŋ s i t
뺘드득	p͈ j ɐ t ɨ t ɨ k
뺘드득뺘드득	p͈ j ɐ t ɨ t ɨ k p͈ j ɐ t ɨ t ɨ k
뺜죽뺜죽	p͈ j ɐ n tɕ u k p͈ j ɐ n tɕ u k
뻐거덕	p͈ ʌ k ʌ t ʌ k
뻐거덕뻐거덕	p͈ ʌ k ʌ t ʌ k p͈ ʌ k ʌ t ʌ k
뻐걱	p͈ ʌ k ʌ k
뻐걱뻐걱	p͈ ʌ k ʌ k p͈ ʌ k ʌ k
뻐그르르	p͈ ʌ k ɨ ɭ ɨ ɭ ɨ
뻐글뻐글	p͈ ʌ k ɨ ɭ p͈ ʌ k ɨ ɭ
뻐금	p͈ ʌ k ɨ m
뻐금뻐금	p͈ ʌ k ɨ m p͈ ʌ k ɨ m
뻐꺼덕	p͈ ʌ k͈ ʌ t ʌ k
뻐꺼덕뻐꺼덕	p͈ ʌ k͈ ʌ t ʌ k p͈ ʌ k͈ ʌ t ʌ k
뻐꺽	p͈ ʌ k͈ ʌ k
뻐꺽뻐꺽	p͈ ʌ k͈ ʌ k p͈ ʌ k͈ ʌ k
뻐꾹	p͈ ʌ k͈ u k
뻐꾹뻐꾹	p͈ ʌ k͈ u k p͈ ʌ k͈ u k
뻐끔	p͈ ʌ k͈ ɨ m
뻐끔뻐끔	p͈ ʌ k͈ ɨ m p͈ ʌ k͈ ɨ m
뻐덕뻐덕	p͈ ʌ t ʌ k p͈ ʌ t ʌ k
뻐득뻐득	p͈ ʌ t ɨ k p͈ ʌ t ɨ k
뻐르적뻐르적	p͈ ʌ ɭ ɨ tɕ ʌ k p͈ ʌ ɭ ɨ tɕ ʌ k
뻐석	p͈ ʌ s ʌ k
뻐석뻐석	p͈ ʌ s ʌ k p͈ ʌ s ʌ k
뻐스럭	p͈ ʌ s ɨ ɭ ʌ k
뻐스럭뻐스럭	p͈ ʌ s ɨ ɭ ʌ k p͈ ʌ s ɨ ɭ ʌ k
뻐적뻐적	p͈ ʌ tɕ ʌ k p͈ ʌ tɕ ʌ k
뻐쩍	p͈ ʌ tɕ͈ ʌ k
뻐쩍뻐쩍	p͈ ʌ tɕ͈ ʌ k p͈ ʌ tɕ͈ ʌ k
뻑	p͈ ʌ k
뻑뻑	p͈ ʌ k p͈ ʌ k
뻔둥뻔둥	p͈ ʌ n t u ŋ p͈ ʌ n t u ŋ
뻔드르르	p͈ ʌ n t ɨ ɭ ɨ ɭ ɨ
뻔득	p͈ ʌ n t ɨ k
뻔득뻔득	p͈ ʌ n t ɨ k p͈ ʌ n t ɨ k
뻔들뻔들	p͈ ʌ n t ɨ ɭ p͈ ʌ n t ɨ ɭ
뻔뜩	p͈ ʌ n t͈ ɨ k
뻔뜩뻔뜩	p͈ ʌ n t͈ ɨ k p͈ ʌ n t͈ ɨ k
뻔적	p͈ ʌ n tɕ ʌ k
뻔적뻔적	p͈ ʌ n tɕ ʌ k p͈ ʌ n tɕ ʌ k
뻔죽뻔죽	p͈ ʌ n tɕ u k p͈ ʌ n tɕ u k
뻔지레	p͈ ʌ n tɕ i ɭ e
뻔지르르	p͈ ʌ n tɕ i ɭ ɨ ɭ ɨ
뻔질	p͈ ʌ n tɕ i ɭ
뻔질뻔질	p͈ ʌ n tɕ i ɭ p͈ ʌ n tɕ i ɭ
뻔쩍	p͈ ʌ n tɕ͈ ʌ k
뻔쩍뻔쩍	p͈ ʌ n tɕ͈ ʌ k p͈ ʌ n tɕ͈ ʌ k
뻘그레	p͈ ʌ ɭ k ɨ ɭ e
뻘긋뻘긋	p͈ ʌ ɭ k ɨ t p͈ ʌ ɭ k ɨ t
뻘꺽	p͈ ʌ ɭ k͈ ʌ k
뻘꺽뻘꺽	p͈ ʌ ɭ k͈ ʌ k p͈ ʌ ɭ k͈ ʌ k
뻘끈	p͈ ʌ ɭ k͈ ɨ n
뻘끈뻘끈	p͈ ʌ ɭ k͈ ɨ n p͈ ʌ ɭ k͈ ɨ n
뻘떡	p͈ ʌ ɭ t͈ ʌ k
뻘떡뻘떡	p͈ ʌ ɭ t͈ ʌ k p͈ ʌ ɭ t͈ ʌ k
뻘렁뻘렁	p͈ ʌ ɭ ɭ ʌ ŋ p͈ ʌ ɭ ɭ ʌ ŋ
뻘뻘	p͈ ʌ ɭ p͈ ʌ ɭ
뻘쭉	p͈ ʌ ɭ tɕ͈ u k
뻘쭉뻘쭉	p͈ ʌ ɭ tɕ͈ u k p͈ ʌ ɭ tɕ͈ u k
뻥	p͈ ʌ ŋ
뻥그레	p͈ ʌ ŋ k ɨ ɭ e
뻥글	p͈ ʌ ŋ k ɨ ɭ
뻥글뻥글	p͈ ʌ ŋ k ɨ ɭ p͈ ʌ ŋ k ɨ ɭ
뻥긋	p͈ ʌ ŋ k ɨ t
뻥긋뻥긋	p͈ ʌ ŋ k ɨ t p͈ ʌ ŋ k ɨ t
뻥끗	p͈ ʌ ŋ k͈ ɨ t
뻥끗뻥끗	p͈ ʌ ŋ k͈ ɨ t p͈ ʌ ŋ k͈ ɨ t
뻥뻥	p͈ ʌ ŋ p͈ ʌ ŋ
뻥시레	p͈ ʌ ŋ s i ɭ e
뻥실	p͈ ʌ ŋ s i ɭ
뻥실뻥실	p͈ ʌ ŋ s i ɭ p͈ ʌ ŋ s i ɭ
뻥싯	p͈ ʌ ŋ s i t
뻥싯뻥싯	p͈ ʌ ŋ s i t p͈ ʌ ŋ s i t
뽀그르르	p͈ o k ɨ ɭ ɨ ɭ ɨ
뽀글뽀글	p͈ o k ɨ ɭ p͈ o k ɨ ɭ
뽀도독	p͈ o t o t o k
뽀도독뽀도독	p͈ o t o t o k p͈ o t o t o k
뽀독뽀독	p͈ o t o k p͈ o t o k
뽀드득	p͈ o t ɨ t ɨ k
뽀드득뽀드득	p͈ o t ɨ t ɨ k p͈ o t ɨ t ɨ k
뽀드등	p͈ o t ɨ t ɨ ŋ
뽀드등뽀드등	p͈ o t ɨ t ɨ ŋ p͈ o t ɨ t ɨ ŋ
뽀르르	p͈ o ɭ ɨ ɭ ɨ
뽀삭	p͈ o s ɐ k
뽀삭뽀삭	p͈ o s ɐ k p͈ o s ɐ k
뽀송뽀송	p͈ o s o ŋ p͈ o s o ŋ
뽀스락	p͈ o s ɨ ɭ ɐ k
뽀스락뽀스락	p͈ o s ɨ ɭ ɐ k p͈ o s ɨ ɭ ɐ k
뽁	p͈ o k
뽁뽁	p͈ o k p͈ o k
뽈긋뽈긋	p͈ o ɭ k ɨ t p͈ o ɭ k ɨ t
뽈끈	p͈ o ɭ k͈ ɨ n
뽈끈뽈끈	p͈ o ɭ k͈ ɨ n p͈ o ɭ k͈ ɨ n
뽈똑	p͈ o ɭ t͈ o k
뽈똑뽈똑	p͈ o ɭ t͈ o k p͈ o ɭ t͈ o k
뽈록	p͈ o ɭ ɭ o k
뽈록뽈록	p͈ o ɭ ɭ o k p͈ o ɭ ɭ o k
뽕	p͈ o ŋ
뽕뽕	p͈ o ŋ p͈ o ŋ
뾰롱뾰롱	p͈ j o ɭ o ŋ p͈ j o ɭ o ŋ
뾰족	p͈ j o tɕ o k
뾰족뾰족	p͈ j o tɕ o k p͈ j o tɕ o k
뾰쪽	p͈ j o tɕ͈ o k
뾰쪽뾰쪽	p͈ j o tɕ͈ o k p͈ j o tɕ͈ o k
뿅	p͈ j o ŋ
뿅뿅	p͈ j o ŋ p͈ j o ŋ
뿌그르르	p͈ u k ɨ ɭ ɨ ɭ ɨ
뿌글뿌글	p͈ u k ɨ ɭ p͈ u k ɨ ɭ
뿌덕뿌덕	p͈ u t ʌ k p͈ u t ʌ k
뿌두둑	p͈ u t u t u k
뿌두둑뿌두둑	p͈ u t u t u k p͈ u t u t u k
뿌둑뿌둑	p͈ u t u k p͈ u t u k
뿌드득	p͈ u t ɨ t ɨ k
뿌드득뿌드득	p͈ u t ɨ t ɨ k p͈ u t ɨ t ɨ k
뿌드등	p͈ u t ɨ t ɨ ŋ
뿌드등뿌드등	p͈ u t ɨ t ɨ ŋ p͈ u t ɨ t ɨ ŋ
뿌득뿌득	p͈ u t ɨ k p͈ u t ɨ k
뿌르르	p͈ u ɭ ɨ ɭ ɨ
뿌석	p͈ u s ʌ k
뿌석뿌석	p͈ u s ʌ k p͈ u s ʌ k
뿌숭뿌숭	p͈ u s u ŋ p͈ u s u ŋ
뿌스럭	p͈ u s ɨ ɭ ʌ k
뿌스럭뿌스럭	p͈ u s ɨ ɭ ʌ k p͈ u s ɨ ɭ ʌ k
뿌지지	p͈ u tɕ i tɕ i
뿌지직	p͈ u tɕ i tɕ i k
뿌지직뿌지직	p͈ u tɕ i tɕ i k p͈ u tɕ i tɕ i k
뿌질뿌질	p͈ u tɕ i ɭ p͈ u tɕ i ɭ
뿍	p͈ u k
뿍뿍	p͈ u k p͈ u k
뿔긋뿔긋	p͈ u ɭ k ɨ t p͈ u ɭ k ɨ t
뿔끈	p͈ u ɭ k͈ ɨ n
뿔끈뿔끈	p͈ u ɭ k͈ ɨ n p͈ u ɭ k͈ ɨ n
뿔뚝	p͈ u ɭ t͈ u k
뿔뚝뿔뚝	p͈ u ɭ t͈ u k p͈ u ɭ t͈ u k
뿔룩	p͈ u ɭ ɭ u k
뿔룩뿔룩	p͈ u ɭ ɭ u k p͈ u ɭ ɭ u k
뿜빠뿜빠	p͈ u m p͈ ɐ p͈ u m p͈ ɐ
뿡	p͈ u ŋ
뿡뿡	p͈ u ŋ p͈ u ŋ
쀼죽	p͈ j u tɕ u k
쀼죽쀼죽	p͈ j u tɕ u k p͈ j u tɕ u k
쀼쭉	p͈ j u tɕ͈ u k
쀼쭉쀼쭉	p͈ j u tɕ͈ u k p͈ j u tɕ͈ u k
삐	p͈ i
삐거걱	p͈ i k ʌ k ʌ k
삐거덕	p͈ i k ʌ t ʌ k
삐거덕삐거덕	p͈ i k ʌ t ʌ k p͈ i k ʌ t ʌ k
삐걱빼각	p͈ i k ʌ k p͈ ɛ k ɐ k
삐국	p͈ i k u k
삐꺼덕	p͈ i k͈ ʌ t ʌ k
삐꺼덕삐꺼덕	p͈ i k͈ ʌ t ʌ k p͈ i k͈ ʌ t ʌ k
삐꺽빼깍	p͈ i k͈ ʌ k p͈ ɛ k͈ ɐ k
삐끗	p͈ i k͈ ɨ t
삐끗삐끗	p͈ i k͈ ɨ t p͈ i k͈ ɨ t
삐드득	p͈ i t ɨ t ɨ k
삐드득삐드득	p͈ i t ɨ t ɨ k p͈ i t ɨ t ɨ k
삐딱삐딱	p͈ i t͈ ɐ k p͈ i t͈ ɐ k
삐뚝삐뚝	p͈ i t͈ u k p͈ i t͈ u k
삐뚤빼뚤	p͈ i t͈ u ɭ p͈ ɛ t͈ u ɭ
삐뚤삐뚤	p͈ i t͈ u ɭ p͈ i t͈ u ɭ
삐빼	p͈ i p͈ ɛ
삐삐	p͈ i p͈ i
삐악	p͈ i ɐ k
삐악삐악	p͈ i ɐ k p͈ i ɐ k
삐오삐오	p͈ i o p͈ i o
삐죽	p͈ i tɕ u k
삐죽빼죽	p͈ i tɕ u k p͈ ɛ tɕ u k
삐죽삐죽	p͈ i tɕ u k p͈ i tɕ u k
삐질삐질	p͈ i tɕ i ɭ p͈ i tɕ i ɭ
삐쩍	p͈ i tɕ͈ ʌ k
삐쭉	p͈ i tɕ͈ u k
삐쭉빼쭉	p͈ i tɕ͈ u k p͈ ɛ tɕ͈ u k
삐쭉삐쭉	p͈ i tɕ͈ u k p͈ i tɕ͈ u k
삐트적삐트적	p͈ i tʰ ɨ tɕ ʌ k p͈ i tʰ ɨ tɕ ʌ k
삐틀삐틀	p͈ i tʰ ɨ ɭ p͈ i tʰ ɨ ɭ
삑	p͈ i k
삑삑	p͈ i k p͈ i k
삔둥삔둥	p͈ i n t u ŋ p͈ i n t u ŋ
삔들삔들	p͈ i n t ɨ ɭ p͈ i n t ɨ ɭ
삘리리삘리리	p͈ i ɭ ɭ i ɭ i p͈ i ɭ ɭ i ɭ i
삥	p͈ i ŋ
삥그레	p͈ i ŋ k ɨ ɭ e
삥그르르	p͈ i ŋ k ɨ ɭ ɨ ɭ ɨ
삥글	p͈ i ŋ k ɨ ɭ
삥글삥글	p͈ i ŋ k ɨ ɭ p͈ i ŋ k ɨ ɭ
삥긋	p͈ i ŋ k ɨ t
삥긋삥긋	p͈ i ŋ k ɨ t p͈ i ŋ k ɨ t
삥끗	p͈ i ŋ k͈ ɨ t
삥끗삥끗	p͈ i ŋ k͈ ɨ t p͈ i ŋ k͈ ɨ t
삥삥	p͈ i ŋ p͈ i ŋ
삥시레	p͈ i ŋ s i ɭ e
삥실	p͈ i ŋ s i ɭ
삥실삥실	p͈ i ŋ s i ɭ p͈ i ŋ s i ɭ
삥싯	p͈ i ŋ s i t
삥싯삥싯	p͈ i ŋ s i t p͈ i ŋ s i t
사각	s ɐ k ɐ k
사각사각	s ɐ k ɐ k s͈ ɐ k ɐ k
사들사들	s ɐ t ɨ ɭ s͈ ɐ t ɨ ɭ
사락사락	s ɐ ɭ ɐ k s͈ ɐ ɭ ɐ k
사르르	s ɐ ɭ ɨ ɭ ɨ
사르륵	s ɐ ɭ ɨ ɭ ɨ k
사르륵사르륵	s ɐ ɭ ɨ ɭ ɨ k s͈ ɐ ɭ ɨ ɭ ɨ k
사리사리	s ɐ ɭ i s ɐ ɭ i
사물사물	s ɐ m u ɭ s͈ ɐ m u ɭ
사박사박	s ɐ p ɐ k s͈ ɐ p ɐ k
사부랑사부랑	s ɐ p u ɭ ɐ ŋ s ɐ p u ɭ ɐ ŋ
사부랑삽작	s ɐ p u ɭ ɐ ŋ s ɐ p tɕ͈ ɐ k
사부작사부작	s ɐ p u tɕ ɐ k s͈ ɐ p u tɕ ɐ k
사분사분	s ɐ p u n s ɐ p u n
사붓	s ɐ p u t
사붓사붓	s ɐ p u t s͈ ɐ p u t
사뿐	s ɐ p͈ u n
사뿐사뿐	s ɐ p͈ u n s ɐ p͈ u n
사뿟	s ɐ p͈ u t
사뿟사뿟	s ɐ p͈ u t s͈ ɐ p͈ u t
사살사살	s ɐ s ɐ ɭ s͈ ɐ s ɐ ɭ
사오락사오락	s ɐ o ɭ ɐ k s͈ ɐ o ɭ ɐ k
사푼	s ɐ pʰ u n
사푼사푼	s ɐ pʰ u n s ɐ pʰ u n
사풋	s ɐ pʰ u t
사풋사풋	s ɐ pʰ u t s͈ ɐ pʰ u t
삭	s ɐ k
삭둑	s ɐ k t͈ u k
삭둑삭둑	s ɐ k t͈ u k s͈ ɐ k t͈ u k
삭삭	s ɐ k s͈ ɐ k
산득	s ɐ n t ɨ k
산득산득	s ɐ n t ɨ k s͈ ɐ n t ɨ k
산들	s ɐ n t ɨ ɭ
산들산들	s ɐ n t ɨ ɭ s͈ ɐ n t ɨ ɭ
산뜩	s ɐ n t͈ ɨ k
산뜩산뜩	s ɐ n t͈ ɨ k s͈ ɐ n t͈ ɨ k
산뜻	s ɐ n t͈ ɨ t
산뜻산뜻	s ɐ n t͈ ɨ t s͈ ɐ n t͈ ɨ t
살강살강	s ɐ ɭ k ɐ ŋ s ɐ ɭ k ɐ ŋ
살근살근	s ɐ ɭ k ɨ n s ɐ ɭ k ɨ n
살금살금	s ɐ ɭ k ɨ m s ɐ ɭ k ɨ m
살긋	s ɐ ɭ k ɨ t
살긋살긋	s ɐ ɭ k ɨ t s͈ ɐ ɭ k ɨ t
살랑	s ɐ ɭ ɭ ɐ ŋ
살랑살랑	s ɐ ɭ ɭ ɐ ŋ s ɐ ɭ ɭ ɐ ŋ
살래살래	s ɐ ɭ ɭ ɛ s ɐ ɭ ɭ ɛ
살망살망	s ɐ ɭ m ɐ ŋ s ɐ ɭ m ɐ ŋ
살몃살몃	s ɐ ɭ m j ʌ t s͈ ɐ ɭ m j ʌ t
살살	s ɐ ɭ s͈ ɐ ɭ
살캉살캉	s ɐ ɭ kʰ ɐ ŋ s ɐ ɭ kʰ ɐ ŋ
살핏살핏	s ɐ ɭ pʰ i t s͈ ɐ ɭ pʰ i t
삼박	s ɐ m p ɐ k
삼박삼박	s ɐ m p ɐ k s͈ ɐ m p ɐ k
삼빡	s ɐ m p͈ ɐ k
삼빡삼빡	s ɐ m p͈ ɐ k s͈ ɐ m p͈ ɐ k
상그레	s ɐ ŋ k ɨ ɭ e
상글	s ɐ ŋ k ɨ ɭ
상글방글	s ɐ ŋ k ɨ ɭ p ɐ ŋ k ɨ ɭ
상글상글	s ɐ ŋ k ɨ ɭ s͈ ɐ ŋ k ɨ ɭ
상긋	s ɐ ŋ k ɨ t
상긋방긋	s ɐ ŋ k ɨ t p͈ ɐ ŋ k ɨ t
상긋상긋	s ɐ ŋ k ɨ t s͈ ɐ ŋ k ɨ t
상깃상깃	s ɐ ŋ k i t s͈ ɐ ŋ k i t
상끗	s ɐ ŋ k͈ ɨ t
상끗방끗	s ɐ ŋ k͈ ɨ t p͈ ɐ ŋ k͈ ɨ t
상끗상끗	s ɐ ŋ k͈ ɨ t s͈ ɐ ŋ k͈ ɨ t
상동	s ɐ ŋ t o ŋ
상동상동	s ɐ ŋ t o ŋ s ɐ ŋ t o ŋ
상큼	s ɐ ŋ kʰ ɨ m
상큼상큼	s ɐ ŋ kʰ ɨ m s ɐ ŋ kʰ ɨ m
새곰새곰	s ɛ k o m s ɛ k o m
새근덕새근덕	s ɛ k ɨ n t ʌ k s͈ ɛ k ɨ n t ʌ k
새근발딱	s ɛ k ɨ n p ɐ ɭ t͈ ɐ k
새근발딱새근발딱	s ɛ k ɨ n p ɐ ɭ t͈ ɐ k s͈ ɛ k ɨ n p ɐ ɭ t͈ ɐ k
새근새근	s ɛ k ɨ n s ɛ k ɨ n
새금새금	s ɛ k ɨ m s ɛ k ɨ m
새득새득	s ɛ t ɨ k s͈ ɛ t ɨ k
새들새들	s ɛ t ɨ ɭ s͈ ɛ t ɨ ɭ
새록새록	s ɛ ɭ o k s͈ ɛ ɭ o k
새롱새롱	s ɛ ɭ o ŋ s ɛ ɭ o ŋ
새물새물	s ɛ m u ɭ s͈ ɛ m u ɭ
새살새살	s ɛ s ɐ ɭ s͈ ɛ s ɐ ɭ
새새	s ɛ s ɛ
새새덕새새덕	s ɛ s ɛ t ʌ k s͈ ɛ s ɛ t ʌ k
새실새실	s ɛ s i ɭ s͈ ɛ s i ɭ
새콤달콤	s ɛ kʰ o m t ɐ ɭ kʰ o m
새콤새콤	s ɛ kʰ o m s ɛ kʰ o m
새큰새큰	s ɛ kʰ ɨ n s ɛ kʰ ɨ n
새큼새큼	s ɛ kʰ ɨ m s ɛ kʰ ɨ m
색	s ɛ k
색색	s ɛ k s͈ ɛ k
샐긋	s ɛ ɭ k ɨ t
샐긋샐긋	s ɛ ɭ k ɨ t s͈ ɛ ɭ k ɨ t
샐기죽	s ɛ ɭ k i tɕ u k
샐기죽샐기죽	s ɛ ɭ k i tɕ u k s͈ ɛ ɭ k i tɕ u k
샐룩	s ɛ ɭ ɭ u k
샐룩샐룩	s ɛ ɭ ɭ u k s͈ ɛ ɭ ɭ u k
샐샐	s ɛ ɭ s͈ ɛ ɭ
샐쭉	s ɛ ɭ tɕ͈ u k
샐쭉샐쭉	s ɛ ɭ tɕ͈ u k s͈ ɛ ɭ tɕ͈ u k
생게망게	s ɛ ŋ k e m ɐ ŋ k e
생그레	s ɛ ŋ k ɨ ɭ e
생글	s ɛ ŋ k ɨ ɭ
생글방글	s ɛ ŋ k ɨ ɭ p ɐ ŋ k ɨ ɭ
생글뱅글	s ɛ ŋ k ɨ ɭ p ɛ ŋ k ɨ ɭ
생글생글	s ɛ ŋ k ɨ ɭ s͈ ɛ ŋ k ɨ ɭ
생긋	s ɛ ŋ k ɨ t
생긋방긋	s ɛ ŋ k ɨ t p͈ ɐ ŋ k ɨ t
생긋뱅긋	s ɛ ŋ k ɨ t p͈ ɛ ŋ k ɨ t
생긋생긋	s ɛ ŋ k ɨ t s͈ ɛ ŋ k ɨ t
생끗	s ɛ ŋ k͈ ɨ t
생끗방끗	s ɛ ŋ k͈ ɨ t p͈ ɐ ŋ k͈ ɨ t
생끗뱅끗	s ɛ ŋ k͈ ɨ t p͈ ɛ ŋ k͈ ɨ t
생끗생끗	s ɛ ŋ k͈ ɨ t s͈ ɛ ŋ k͈ ɨ t
생동생동	s ɛ ŋ t o ŋ s ɛ ŋ t o ŋ
서걱	s ʌ k ʌ k
서걱서걱	s ʌ k ʌ k s͈ ʌ k ʌ k
서리서리	s ʌ ɭ i s ʌ ɭ i
서물서물	s ʌ m u ɭ s͈ ʌ m u ɭ
서벅서벅	s ʌ p ʌ k s͈ ʌ p ʌ k
서부렁서부렁	s ʌ p u ɭ ʌ ŋ s ʌ p u ɭ ʌ ŋ
서부렁섭적	s ʌ p u ɭ ʌ ŋ s ʌ p tɕ͈ ʌ k
서분서분	s ʌ p u n s ʌ p u n
서붓	s ʌ p u t
서붓서붓	s ʌ p u t s͈ ʌ p u t
서뿐	s ʌ p͈ u n
서뿐서뿐	s ʌ p͈ u n s ʌ p͈ u n
서뿟	s ʌ p͈ u t
서뿟서뿟	s ʌ p͈ u t s͈ ʌ p͈ u t
서성서성	s ʌ s ʌ ŋ s ʌ s ʌ ŋ
서슴서슴	s ʌ s ɨ m s ʌ s ɨ m
서털구털	s ʌ tʰ ʌ ɭ k u tʰ ʌ ɭ
서푼	s ʌ pʰ u n
서푼서푼	s ʌ pʰ u n s ʌ pʰ u n
서풋	s ʌ pʰ u t
서풋서풋	s ʌ pʰ u t s͈ ʌ pʰ u t
석	s ʌ k
석둑	s ʌ k t͈ u k
석둑석둑	s ʌ k t͈ u k s͈ ʌ k t͈ u k
석석	s ʌ k s͈ ʌ k
선득	s ʌ n t ɨ k
선득선득	s ʌ n t ɨ k s͈ ʌ n t ɨ k
선들	s ʌ n t ɨ ɭ
선들선들	s ʌ n t ɨ ɭ s͈ ʌ n t ɨ ɭ
선뜩	s ʌ n t͈ ɨ k
선뜩선뜩	s ʌ n t͈ ɨ k s͈ ʌ n t͈ ɨ k
선뜻	s ʌ n t͈ ɨ t
선뜻선뜻	s ʌ n t͈ ɨ t s͈ ʌ n t͈ ɨ t
설겅설겅	s ʌ ɭ k ʌ ŋ s ʌ ɭ k ʌ ŋ
설렁	s ʌ ɭ ɭ ʌ ŋ
설렁설렁	s ʌ ɭ ɭ ʌ ŋ s ʌ ɭ ɭ ʌ ŋ
설레설레	s ʌ ɭ ɭ e s ʌ ɭ ɭ e
설멍설멍	s ʌ ɭ m ʌ ŋ s ʌ ɭ m ʌ ŋ
설설	s ʌ ɭ s͈ ʌ ɭ
설컹설컹	s ʌ ɭ kʰ ʌ ŋ s ʌ ɭ kʰ ʌ ŋ
설핏	s ʌ ɭ pʰ i t
설핏설핏	s ʌ ɭ pʰ i t s͈ ʌ ɭ pʰ i t
섬뜩	s ʌ m t͈ ɨ k
섬뜩섬뜩	s ʌ m t͈ ɨ k s͈ ʌ m t͈ ɨ k
섬벅	s ʌ m p ʌ k
섬벅섬벅	s ʌ m p ʌ k s͈ ʌ m p ʌ k
섬뻑	s ʌ m p͈ ʌ k
섬뻑섬뻑	s ʌ m p͈ ʌ k s͈ ʌ m p͈ ʌ k
섬찟	s ʌ m tɕ͈ i t
섬찟섬찟	s ʌ m tɕ͈ i t s͈ ʌ m tɕ͈ i t
섭적	s ʌ p tɕ͈ ʌ k
성그레	s ʌ ŋ k ɨ ɭ e
성글	s ʌ ŋ k ɨ ɭ
성글벙글	s ʌ ŋ k ɨ ɭ p ʌ ŋ k ɨ ɭ
성글성글	s ʌ ŋ k ɨ ɭ s͈ ʌ ŋ k ɨ ɭ
성긋	s ʌ ŋ k ɨ t
성긋벙긋	s ʌ ŋ k ɨ t p͈ ʌ ŋ k ɨ t
성긋성긋	s ʌ ŋ k ɨ t s͈ ʌ ŋ k ɨ t
성깃성깃	s ʌ ŋ k i t s͈ ʌ ŋ k i t
성끗	s ʌ ŋ k͈ ɨ t
성끗벙끗	s ʌ ŋ k͈ ɨ t p͈ ʌ ŋ k͈ ɨ t
성끗성끗	s ʌ ŋ k͈ ɨ t s͈ ʌ ŋ k͈ ɨ t
성둥	s ʌ ŋ t u ŋ
성둥성둥	s ʌ ŋ t u ŋ s ʌ ŋ t u ŋ
성큼	s ʌ ŋ kʰ ɨ m
성큼성큼	s ʌ ŋ kʰ ɨ m s ʌ ŋ kʰ ɨ m
소곤닥소곤닥	s o k o n t ɐ k s͈ o k o n t ɐ k
소곤소곤	s o k o n s o k o n
소곳소곳	s o k o t s͈ o k o t
소득소득	s o t ɨ k s͈ o t ɨ k
소들소들	s o t ɨ ɭ s͈ o t ɨ ɭ
소락소락	s o ɭ ɐ k s͈ o ɭ ɐ k
소록소록	s o ɭ o k s͈ o ɭ o k
소르르	s o ɭ ɨ ɭ ɨ
소리소리	s o ɭ i s o ɭ i
소마소마	s o m ɐ s o m ɐ
소말소말	s o m ɐ ɭ s͈ o m ɐ ɭ
소복소복	s o p o k s͈ o p o k
소소리	s o s o ɭ i
소쩍	s o tɕ͈ ʌ k
소쩍소쩍	s o tɕ͈ ʌ k s͈ o tɕ͈ ʌ k
속닥속닥	s o k t͈ ɐ k s͈ o k t͈ ɐ k
속달속달	s o k t͈ ɐ ɭ s͈ o k t͈ ɐ ɭ
속삭속삭	s o k s͈ ɐ k s͈ o k s͈ ɐ k
속살속살	s o k s͈ ɐ ɭ s͈ o k s͈ ɐ ɭ
솔래솔래	s o ɭ ɭ ɛ s o ɭ ɭ ɛ
솔솔	s o ɭ s͈ o ɭ
솜솜	s o m s o m
송골송골	s o ŋ k o ɭ s͈ o ŋ k o ɭ
송당	s o ŋ t ɐ ŋ
송당송당	s o ŋ t ɐ ŋ s o ŋ t ɐ ŋ
송송	s o ŋ s o ŋ
송알송알	s o ŋ ɐ ɭ s͈ o ŋ ɐ ɭ
솨	s w ɐ
솨르르	s w ɐ ɭ ɨ ɭ ɨ
솨솨	s w ɐ s w ɐ
솰솰	s w ɐ ɭ s͈ w ɐ ɭ
쇄	s w ɛ
쇄쇄	s w ɛ s w ɛ
수걱수걱	s u k ʌ k s͈ u k ʌ k
수군덕수군덕	s u k u n t ʌ k s͈ u k u n t ʌ k
수군수군	s u k u n s u k u n
수군숙덕	s u k u n s u k t͈ ʌ k
수굿수굿	s u k u t s͈ u k u t
수득수득	s u t ɨ k s͈ u t ɨ k
수들수들	s u t ɨ ɭ s͈ u t ɨ ɭ
수럭수럭	s u ɭ ʌ k s͈ u ɭ ʌ k
수런수런	s u ɭ ʌ n s u ɭ ʌ n
수르르	s u ɭ ɨ ɭ ɨ
수리수리	s u ɭ i s u ɭ i
수북수북	s u p u k s͈ u p u k
수선수선	s u s ʌ n s u s ʌ n
수슬수슬	s u s ɨ ɭ s͈ u s ɨ ɭ
수월수월	s u w ʌ ɭ s͈ u w ʌ ɭ
숙덕숙덕	s u k t͈ ʌ k s͈ u k t͈ ʌ k
숙덜숙덜	s u k t͈ ʌ ɭ s͈ u k t͈ ʌ ɭ
숙설숙설	s u k s͈ ʌ ɭ s͈ u k s͈ ʌ ɭ
술렁술렁	s u ɭ ɭ ʌ ŋ s u ɭ ɭ ʌ ŋ
술술	s u ɭ s͈ u ɭ
숨숨	s u m s u m
숭굴숭굴	s u ŋ k u ɭ s͈ u ŋ k u ɭ
숭덩	s u ŋ t ʌ ŋ
숭덩숭덩	s u ŋ t ʌ ŋ s u ŋ t ʌ ŋ
숭숭	s u ŋ s u ŋ
숭얼숭얼	s u ŋ ʌ ɭ s͈ u ŋ ʌ ɭ
쉬엄쉬엄	s w i ʌ m s w i ʌ m
쉭	s w i k
쉭쉭	s w i k s͈ w i k
스렁스렁	s ɨ ɭ ʌ ŋ s ɨ ɭ ʌ ŋ
스르렁	s ɨ ɭ ɨ ɭ ʌ ŋ
스르르	s ɨ ɭ ɨ ɭ ɨ
스르륵	s ɨ ɭ ɨ ɭ ɨ k
스르륵스르륵	s ɨ ɭ ɨ ɭ ɨ k s͈ ɨ ɭ ɨ ɭ ɨ k
스멀스멀	s ɨ m ʌ ɭ s͈ ɨ m ʌ ɭ
스적스적	s ɨ tɕ ʌ k s͈ ɨ tɕ ʌ k
슬겅슬겅	s ɨ ɭ k ʌ ŋ s ɨ ɭ k ʌ ŋ
슬근슬근	s ɨ ɭ k ɨ n s ɨ ɭ k ɨ n
슬금슬금	s ɨ ɭ k ɨ m s ɨ ɭ k ɨ m
슬렁슬렁	s ɨ ɭ ɭ ʌ ŋ s ɨ ɭ ɭ ʌ ŋ
슬몃슬몃	s ɨ ɭ m j ʌ t s͈ ɨ ɭ m j ʌ t
슬슬	s ɨ ɭ s͈ ɨ ɭ
슴벅	s ɨ m p ʌ k
슴벅슴벅	s ɨ m p ʌ k s͈ ɨ m p ʌ k
슴뻑	s ɨ m p͈ ʌ k
슴뻑슴뻑	s ɨ m p͈ ʌ k s͈ ɨ m p͈ ʌ k
시굼시굼	s i k u m s i k u m
시근덕시근덕	s i k ɨ n t ʌ k s͈ i k ɨ n t ʌ k
시근벌떡	s i k ɨ n p ʌ ɭ t͈ ʌ k
시근벌떡시근벌떡	s i k ɨ n p ʌ ɭ t͈ ʌ k s͈ i k ɨ n p ʌ ɭ t͈ ʌ k
시근시근	s i k ɨ n s i k ɨ n
시글시글	s i k ɨ ɭ s͈ i k ɨ ɭ
시금시금	s i k ɨ m s i k ɨ m
시끌벅적	s i k͈ ɨ ɭ p ʌ k tɕ͈ ʌ k
시끌시끌	s i k͈ ɨ ɭ s͈ i k͈ ɨ ɭ
시난고난	s i n ɐ n k o n ɐ n
시드럭부드럭	s i t ɨ ɭ ʌ k p͈ u t ɨ ɭ ʌ k
시드럭시드럭	s i t ɨ ɭ ʌ k s͈ i t ɨ ɭ ʌ k
시들부들	s i t ɨ ɭ p u t ɨ ɭ
시들시들	s i t ɨ ɭ s͈ i t ɨ ɭ
시룽새롱	s i ɭ u ŋ s ɛ ɭ o ŋ
시룽시룽	s i ɭ u ŋ s i ɭ u ŋ
시르렁둥당	s i ɭ ɨ ɭ ʌ ŋ t u ŋ t ɐ ŋ
시름시름	s i ɭ ɨ m s i ɭ ɨ m
시물새물	s i m u ɭ s͈ ɛ m u ɭ
시물시물	s i m u ɭ s͈ i m u ɭ
시부렁시부렁	s i p u ɭ ʌ ŋ s i p u ɭ ʌ ŋ
시부적시부적	s i p u tɕ ʌ k s͈ i p u tɕ ʌ k
시설시설	s i s ʌ ɭ s͈ i s ʌ ɭ
시시닥시시닥	s i s i t ɐ k s͈ i s i t ɐ k
시시덕시시덕	s i s i t ʌ k s͈ i s i t ʌ k
시시콜콜	s i s i kʰ o ɭ kʰ o ɭ
시실시실	s i s i ɭ s͈ i s i ɭ
시원시원	s i w ʌ n s i w ʌ n
시위적시위적	s i w i tɕ ʌ k s͈ i w i tɕ ʌ k
시적시적	s i tɕ ʌ k s͈ i tɕ ʌ k
시콩시콩	s i kʰ o ŋ s i kʰ o ŋ
시쿰시쿰	s i kʰ u m s i kʰ u m
시큰시큰	s i kʰ ɨ n s i kʰ ɨ n
시큼시큼	s i kʰ ɨ m s i kʰ ɨ m
식	s i k
식식	s i k s͈ i k
신들신들	s i n t ɨ ɭ s͈ i n t ɨ ɭ
실긋	s i ɭ k ɨ t
실긋샐긋	s i ɭ k ɨ t s͈ ɛ ɭ k ɨ t
실긋실긋	s i ɭ k ɨ t s͈ i ɭ k ɨ t
실기죽	s i ɭ k i tɕ u k
실기죽샐기죽	s i ɭ k i tɕ u k s͈ ɛ ɭ k i tɕ u k
실기죽실기죽	s i ɭ k i tɕ u k s͈ i ɭ k i tɕ u k
실떡실떡	s i ɭ t͈ ʌ k s͈ i ɭ t͈ ʌ k
실룩	s i ɭ ɭ u k
실룩샐룩	s i ɭ ɭ u k s͈ ɛ ɭ ɭ u k
실룩실룩	s i ɭ ɭ u k s͈ i ɭ ɭ u k
실실	s i ɭ s͈ i ɭ
실쭉	s i ɭ tɕ͈ u k
실쭉샐쭉	s i ɭ tɕ͈ u k s͈ ɛ ɭ tɕ͈ u k
실쭉실쭉	s i ɭ tɕ͈ u k s͈ i ɭ tɕ͈ u k
싱그레	s i ŋ k ɨ ɭ e
싱글	s i ŋ k ɨ ɭ
싱글벙글	s i ŋ k ɨ ɭ p ʌ ŋ k ɨ ɭ
싱글빙글	s i ŋ k ɨ ɭ p i ŋ k ɨ ɭ
싱글싱글	s i ŋ k ɨ ɭ s͈ i ŋ k ɨ ɭ
싱긋	s i ŋ k ɨ t
싱긋벙긋	s i ŋ k ɨ t p͈ ʌ ŋ k ɨ t
싱긋빙긋	s i ŋ k ɨ t p͈ i ŋ k ɨ t
싱긋싱긋	s i ŋ k ɨ t s͈ i ŋ k ɨ t
싱끗	s i ŋ k͈ ɨ t
싱끗벙끗	s i ŋ k͈ ɨ t p͈ ʌ ŋ k͈ ɨ t
싱끗빙끗	s i ŋ k͈ ɨ t p͈ i ŋ k͈ ɨ t
싱끗싱끗	s i ŋ k͈ ɨ t s͈ i ŋ k͈ ɨ t
싱둥싱둥	s i ŋ t u ŋ s i ŋ t u ŋ
싱숭생숭	s i ŋ s u ŋ s ɛ ŋ s u ŋ
싸각	s͈ ɐ k ɐ k
싸각싸각	s͈ ɐ k ɐ k s͈ ɐ k ɐ k
싸락싸락	s͈ ɐ ɭ ɐ k s͈ ɐ ɭ ɐ k
싸르락	s͈ ɐ ɭ ɨ ɭ ɐ k
싸르락싸르락	s͈ ɐ ɭ ɨ ɭ ɐ k s͈ ɐ ɭ ɨ ɭ ɐ k
싸르륵	s͈ ɐ ɭ ɨ ɭ ɨ k
싸르륵싸르륵	s͈ ɐ ɭ ɨ ɭ ɨ k s͈ ɐ ɭ ɨ ɭ ɨ k
싸부랑싸부랑	s͈ ɐ p u ɭ ɐ ŋ s͈ ɐ p u ɭ ɐ ŋ
싹	s͈ ɐ k
싹둑	s͈ ɐ k t͈ u k
싹둑싹둑	s͈ ɐ k t͈ u k s͈ ɐ k t͈ u k
싹싹	s͈ ɐ k s͈ ɐ k
쌀강쌀강	s͈ ɐ ɭ k ɐ ŋ s͈ ɐ ɭ k ɐ ŋ
쌀긋	s͈ ɐ ɭ k ɨ t
쌀긋쌀긋	s͈ ɐ ɭ k ɨ t s͈ ɐ ɭ k ɨ t
쌀랑쌀랑	s͈ ɐ ɭ ɭ ɐ ŋ s͈ ɐ ɭ ɭ ɐ ŋ
쌀래쌀래	s͈ ɐ ɭ ɭ ɛ s͈ ɐ ɭ ɭ ɛ
쌀쌀	s͈ ɐ ɭ s͈ ɐ ɭ
쌀캉쌀캉	s͈ ɐ ɭ kʰ ɐ ŋ s͈ ɐ ɭ kʰ ɐ ŋ
쌈박	s͈ ɐ m p ɐ k
쌈박쌈박	s͈ ɐ m p ɐ k s͈ ɐ m p ɐ k
쌈빡	s͈ ɐ m p͈ ɐ k
쌈빡쌈빡	s͈ ɐ m p͈ ɐ k s͈ ɐ m p͈ ɐ k
쌍그레	s͈ ɐ ŋ k ɨ ɭ e
쌍글	s͈ ɐ ŋ k ɨ ɭ
쌍글빵글	s͈ ɐ ŋ k ɨ ɭ p͈ ɐ ŋ k ɨ ɭ
쌍글쌍글	s͈ ɐ ŋ k ɨ ɭ s͈ ɐ ŋ k ɨ ɭ
쌍긋	s͈ ɐ ŋ k ɨ t
쌍긋빵긋	s͈ ɐ ŋ k ɨ t p͈ ɐ ŋ k ɨ t
쌍긋쌍긋	s͈ ɐ ŋ k ɨ t s͈ ɐ ŋ k ɨ t
쌍끗	s͈ ɐ ŋ k͈ ɨ t
쌍끗빵끗	s͈ ɐ ŋ k͈ ɨ t p͈ ɐ ŋ k͈ ɨ t
쌍끗쌍끗	s͈ ɐ ŋ k͈ ɨ t s͈ ɐ ŋ k͈ ɨ t
쌍동	s͈ ɐ ŋ t o ŋ
쌍동쌍동	s͈ ɐ ŋ t o ŋ s͈ ɐ ŋ t o ŋ
쌔근덕쌔근덕	s͈ ɛ k ɨ n t ʌ k s͈ ɛ k ɨ n t ʌ k
쌔근발딱	s͈ ɛ k ɨ n p ɐ ɭ t͈ ɐ k
쌔근발딱쌔근발딱	s͈ ɛ k ɨ n p ɐ ɭ t͈ ɐ k s͈ ɛ k ɨ n p ɐ ɭ t͈ ɐ k
쌔근쌔근	s͈ ɛ k ɨ n s͈ ɛ k ɨ n
쌔근팔딱	s͈ ɛ k ɨ n pʰ ɐ ɭ t͈ ɐ k
쌔근팔딱쌔근팔딱	s͈ ɛ k ɨ n pʰ ɐ ɭ t͈ ɐ k s͈ ɛ k ɨ n pʰ ɐ ɭ t͈ ɐ k
쌔물쌔물	s͈ ɛ m u ɭ s͈ ɛ m u ɭ
쌕	s͈ ɛ k
쌕쌕	s͈ ɛ k s͈ ɛ k
쌜긋	s͈ ɛ ɭ k ɨ t
쌜긋쌜긋	s͈ ɛ ɭ k ɨ t s͈ ɛ ɭ k ɨ t
쌜기죽	s͈ ɛ ɭ k i tɕ u k
쌜기죽쌜기죽	s͈ ɛ ɭ k i tɕ u k s͈ ɛ ɭ k i tɕ u k
쌜룩	s͈ ɛ ɭ ɭ u k
쌜룩쌜룩	s͈ ɛ ɭ ɭ u k s͈ ɛ ɭ ɭ u k
쌜쭉	s͈ ɛ ɭ tɕ͈ u k
쌜쭉쌜쭉	s͈ ɛ ɭ tɕ͈ u k s͈ ɛ ɭ tɕ͈ u k
쌩	s͈ ɛ ŋ
쌩그레	s͈ ɛ ŋ k ɨ ɭ e
쌩글	s͈ ɛ ŋ k ɨ ɭ
쌩글빵글	s͈ ɛ ŋ k ɨ ɭ p͈ ɐ ŋ k ɨ ɭ
쌩글뺑글	s͈ ɛ ŋ k ɨ ɭ p͈ ɛ ŋ k ɨ ɭ
쌩글쌩글	s͈ ɛ ŋ k ɨ ɭ s͈ ɛ ŋ k ɨ ɭ
쌩긋	s͈ ɛ ŋ k ɨ t
쌩긋빵긋	s͈ ɛ ŋ k ɨ t p͈ ɐ ŋ k ɨ t
쌩긋뺑긋	s͈ ɛ ŋ k ɨ t p͈ ɛ ŋ k ɨ t
쌩긋쌩긋	s͈ ɛ ŋ k ɨ t s͈ ɛ ŋ k ɨ t
쌩끗	s͈ ɛ ŋ k͈ ɨ t
쌩끗빵끗	s͈ ɛ ŋ k͈ ɨ t p͈ ɐ ŋ k͈ ɨ t
쌩끗뺑끗	s͈ ɛ ŋ k͈ ɨ t p͈ ɛ ŋ k͈ ɨ t
쌩끗쌩끗	s͈ ɛ ŋ k͈ ɨ t s͈ ɛ ŋ k͈ ɨ t
쌩쌩	s͈ ɛ ŋ s͈ ɛ ŋ
써걱	s͈ ʌ k ʌ k
써걱써걱	s͈ ʌ k ʌ k s͈ ʌ k ʌ k
썩	s͈ ʌ k
썩둑	s͈ ʌ k t͈ u k
썩둑썩둑	s͈ ʌ k t͈ u k s͈ ʌ k t͈ u k
썩썩	s͈ ʌ k s͈ ʌ k
썰겅썰겅	s͈ ʌ ɭ k ʌ ŋ s͈ ʌ ɭ k ʌ ŋ
썰렁썰렁	s͈ ʌ ɭ ɭ ʌ ŋ s͈ ʌ ɭ ɭ ʌ ŋ
썰레썰레	s͈ ʌ ɭ ɭ e s͈ ʌ ɭ ɭ e
썰썰	s͈ ʌ ɭ s͈ ʌ ɭ
썰컹썰컹	s͈ ʌ ɭ kʰ ʌ ŋ s͈ ʌ ɭ kʰ ʌ ŋ
썸벅	s͈ ʌ m p ʌ k
썸벅썸벅	s͈ ʌ m p ʌ k s͈ ʌ m p ʌ k
썸뻑	s͈ ʌ m p͈ ʌ k
썸뻑썸뻑	s͈ ʌ m p͈ ʌ k s͈ ʌ m p͈ ʌ k
썽그레	s͈ ʌ ŋ k ɨ ɭ e
썽글	s͈ ʌ ŋ k ɨ ɭ
썽글뻥글	s͈ ʌ ŋ k ɨ ɭ p͈ ʌ ŋ k ɨ ɭ
썽글썽글	s͈ ʌ ŋ k ɨ ɭ s͈ ʌ ŋ k ɨ ɭ
썽긋	s͈ ʌ ŋ k ɨ t
썽긋뻥긋	s͈ ʌ ŋ k ɨ t p͈ ʌ ŋ k ɨ t
썽긋썽긋	s͈ ʌ ŋ k ɨ t s͈ ʌ ŋ k ɨ t
썽끗	s͈ ʌ ŋ k͈ ɨ t
썽끗뻥끗	s͈ ʌ ŋ k͈ ɨ t p͈ ʌ ŋ k͈ ɨ t
썽끗썽끗	s͈ ʌ ŋ k͈ ɨ t s͈ ʌ ŋ k͈ ɨ t
썽둥	s͈ ʌ ŋ t u ŋ
썽둥썽둥	s͈ ʌ ŋ t u ŋ s͈ ʌ ŋ t u ŋ
쏘곤닥쏘곤닥	s͈ o k o n t ɐ k s͈ o k o n t ɐ k
쏘곤쏘곤	s͈ o k o n s͈ o k o n
쏘삭쏘삭	s͈ o s ɐ k s͈ o s ɐ k
쏙	s͈ o k
쏙닥쏙닥	s͈ o k t͈ ɐ k s͈ o k t͈ ɐ k
쏙달쏙달	s͈ o k t͈ ɐ ɭ s͈ o k t͈ ɐ ɭ
쏙살쏙살	s͈ o k s͈ ɐ ɭ s͈ o k s͈ ɐ ɭ
쏙쏙	s͈ o k s͈ o k
쏠라닥쏠라닥	s͈ o ɭ ɭ ɐ t ɐ k s͈ o ɭ ɭ ɐ t ɐ k
쏠쏠	s͈ o ɭ s͈ o ɭ
쏭당	s͈ o ŋ t ɐ ŋ
쏭당쏭당	s͈ o ŋ t ɐ ŋ s͈ o ŋ t ɐ ŋ
쏴	s͈ w ɐ
쏴르르	s͈ w ɐ ɭ ɨ ɭ ɨ
쏴쏴	s͈ w ɐ s͈ w ɐ
쏼쏼	s͈ w ɐ ɭ s͈ w ɐ ɭ
쐐	s͈ w ɛ
쐐쐐	s͈ w ɛ s͈ w ɛ
쑤걱쑤걱	s͈ u k ʌ k s͈ u k ʌ k
쑤군덕쑤군덕	s͈ u k u n t ʌ k s͈ u k u n t ʌ k
쑤군쑤군	s͈ u k u n s͈ u k u n
쑤석쑤석	s͈ u s ʌ k s͈ u s ʌ k
쑥	s͈ u k
쑥덕쑥덕	s͈ u k t͈ ʌ k s͈ u k t͈ ʌ k
쑥덜쑥덜	s͈ u k t͈ ʌ ɭ s͈ u k t͈ ʌ ɭ
쑥설쑥설	s͈ u k s͈ ʌ ɭ s͈ u k s͈ ʌ ɭ
쑥쑥	s͈ u k s͈ u k
쑬쑬	s͈ u ɭ s͈ u ɭ
쑹덩	s͈ u ŋ t ʌ ŋ
쑹덩쑹덩	s͈ u ŋ t ʌ ŋ s͈ u ŋ t ʌ ŋ
쓰렁쓰렁	s͈ ɨ ɭ ʌ ŋ s͈ ɨ ɭ ʌ ŋ
쓰르륵	s͈ ɨ ɭ ɨ ɭ ɨ k
쓰르륵쓰르륵	s͈ ɨ ɭ ɨ ɭ ɨ k s͈ ɨ ɭ ɨ ɭ ɨ k
쓰름쓰름	s͈ ɨ ɭ ɨ m s͈ ɨ ɭ ɨ m
쓰적쓰적	s͈ ɨ tɕ ʌ k s͈ ɨ tɕ ʌ k
쓱	s͈ ɨ k
쓱싹	s͈ ɨ k s͈ ɐ k
쓱싹쓱싹	s͈ ɨ k s͈ ɐ k s͈ ɨ k s͈ ɐ k
쓱쓱	s͈ ɨ k s͈ ɨ k
쓸쓸	s͈ ɨ ɭ s͈ ɨ ɭ
씀벅	s͈ ɨ m p ʌ k
씀벅씀벅	s͈ ɨ m p ʌ k s͈ ɨ m p ʌ k
씀뻑	s͈ ɨ m p͈ ʌ k
씀뻑씀뻑	s͈ ɨ m p͈ ʌ k s͈ ɨ m p͈ ʌ k
씨근덕씨근덕	s͈ i k ɨ n t ʌ k s͈ i k ɨ n t ʌ k
씨근벌떡	s͈ i k ɨ n p ʌ ɭ t͈ ʌ k
씨근벌떡씨근벌떡	s͈ i k ɨ n p ʌ ɭ t͈ ʌ k s͈ i k ɨ n p ʌ ɭ t͈ ʌ k
씨근씨근	s͈ i k ɨ n s͈ i k ɨ n
씨근펄떡	s͈ i k ɨ n pʰ ʌ ɭ t͈ ʌ k
씨근펄떡씨근펄떡	s͈ i k ɨ n pʰ ʌ ɭ t͈ ʌ k s͈ i k ɨ n pʰ ʌ ɭ t͈ ʌ k
씨르륵	s͈ i ɭ ɨ ɭ ɨ k
씨르륵씨르륵	s͈ i ɭ ɨ ɭ ɨ k s͈ i ɭ ɨ ɭ ɨ k
씨물쌔물	s͈ i m u ɭ s͈ ɛ m u ɭ
씨물씨물	s͈ i m u ɭ s͈ i m u ɭ
씨부렁씨부렁	s͈ i p u ɭ ʌ ŋ s͈ i p u ɭ ʌ ŋ
씨불씨불	s͈ i p u ɭ s͈ i p u ɭ
씨억씨억	s͈ i ʌ k s͈ i ʌ k
씨엉씨엉	s͈ i ʌ ŋ s͈ i ʌ ŋ
씨우적씨우적	s͈ i u tɕ ʌ k s͈ i u tɕ ʌ k
씩	s͈ i k
씩둑	s͈ i k t͈ u k
씩둑꺽둑	s͈ i k t͈ u k k͈ ʌ k t͈ u k
씩둑씩둑	s͈ i k t͈ u k s͈ i k t͈ u k
씩씩	s͈ i k s͈ i k
씰긋	s͈ i ɭ k ɨ t
씰긋쌜긋	s͈ i ɭ k ɨ t s͈ ɛ ɭ k ɨ t
씰긋씰긋	s͈ i ɭ k ɨ t s͈ i ɭ k ɨ t
씰기죽	s͈ i ɭ k i tɕ u k
씰기죽쌜기죽	s͈ i ɭ k i tɕ u k s͈ ɛ ɭ k i tɕ u k
씰기죽씰기죽	s͈ i ɭ k i tɕ u k s͈ i ɭ k i tɕ u k
씰룩	s͈ i ɭ ɭ u k
씰룩쌜룩	s͈ i ɭ ɭ u k s͈ ɛ ɭ ɭ u k
씰룩씰룩	s͈ i ɭ ɭ u k s͈ i ɭ ɭ u k
씰쭉	s͈ i ɭ tɕ͈ u k
씰쭉쌜쭉	s͈ i ɭ tɕ͈ u k s͈ ɛ ɭ tɕ͈ u k
씰쭉씰쭉	s͈ i ɭ tɕ͈ u k s͈ i ɭ tɕ͈ u k
씽	s͈ i ŋ
씽그레	s͈ i ŋ k ɨ ɭ e
씽글	s͈ i ŋ k ɨ ɭ
씽글뻥글	s͈ i ŋ k ɨ ɭ p͈ ʌ ŋ k ɨ ɭ
씽글삥글	s͈ i ŋ k ɨ ɭ p͈ i ŋ k ɨ ɭ
씽글씽글	s͈ i ŋ k ɨ ɭ s͈ i ŋ k ɨ ɭ
씽긋	s͈ i ŋ k ɨ t
씽긋뻥긋	s͈ i ŋ k ɨ t p͈ ʌ ŋ k ɨ t
씽긋삥긋	s͈ i ŋ k ɨ t p͈ i ŋ k ɨ t
씽긋씽긋	s͈ i ŋ k ɨ t s͈ i ŋ k ɨ t
씽끗	s͈ i ŋ k͈ ɨ t
씽끗뻥끗	s͈ i ŋ k͈ ɨ t p͈ ʌ ŋ k͈ ɨ t
씽끗삥끗	s͈ i ŋ k͈ ɨ t p͈ i ŋ k͈ ɨ t
씽끗씽끗	s͈ i ŋ k͈ ɨ t s͈ i ŋ k͈ ɨ t
씽씽	s͈ i ŋ s͈ i ŋ
아귀아귀	ɐ k w i ɐ k w i
아근바근	ɐ k ɨ n p ɐ k ɨ n
아긋아긋	ɐ k ɨ s ɐ k ɨ t
아기똥아기똥	ɐ k i t͈ o ŋ ɐ k i t͈ o ŋ
아기자기	ɐ k i tɕ ɐ k i
아기작아기작	ɐ k i tɕ ɐ k ɐ k i tɕ ɐ k
아기족아기족	ɐ k i tɕ o k ɐ k i tɕ o k
아느작아느작	ɐ n ɨ tɕ ɐ k ɐ n ɨ tɕ ɐ k
아늘아늘	ɐ n ɨ ɭ ɐ n ɨ ɭ
아닥치듯	ɐ t ɐ k tɕʰ i t ɨ t
아드득	ɐ t ɨ t ɨ k
아드득아드득	ɐ t ɨ t ɨ k ɐ t ɨ t ɨ k
아드등아드등	ɐ t ɨ t ɨ ŋ ɐ t ɨ t ɨ ŋ
아득바득	ɐ t ɨ k p͈ ɐ t ɨ k
아득아득	ɐ t ɨ k ɐ t ɨ k
아등바등	ɐ t ɨ ŋ p ɐ t ɨ ŋ
아등아등	ɐ t ɨ ŋ ɐ t ɨ ŋ
아뜩아뜩	ɐ t͈ ɨ k ɐ t͈ ɨ k
아락바락	ɐ ɭ ɐ k p͈ ɐ ɭ ɐ k
아로록다로록	ɐ ɭ o ɭ o k t͈ ɐ ɭ o ɭ o k
아로록아로록	ɐ ɭ o ɭ o k ɐ ɭ o ɭ o k
아로롱다로롱	ɐ ɭ o ɭ o ŋ t ɐ ɭ o ɭ o ŋ
아로롱아로롱	ɐ ɭ o ɭ o ŋ ɐ ɭ o ɭ o ŋ
아롱다롱	ɐ ɭ o ŋ t ɐ ɭ o ŋ
아롱아롱	ɐ ɭ o ŋ ɐ ɭ o ŋ
아르렁	ɐ ɭ ɨ ɭ ʌ ŋ
아르렁아르렁	ɐ ɭ ɨ ɭ ʌ ŋ ɐ ɭ ɨ ɭ ʌ ŋ
아르르	ɐ ɭ ɨ ɭ ɨ
아른아른	ɐ ɭ ɨ n ɐ ɭ ɨ n
아름아름	ɐ ɭ ɨ m ɐ ɭ ɨ m
아름작아름작	ɐ ɭ ɨ m tɕ ɐ k ɐ ɭ ɨ m tɕ ɐ k
아리송아리송	ɐ ɭ i s o ŋ ɐ ɭ i s o ŋ
아릿아릿	ɐ ɭ i s ɐ ɭ i t
아릿자릿	ɐ ɭ i t tɕ͈ ɐ ɭ i t
아물아물	ɐ m u ɭ ɐ m u ɭ
아삭	ɐ s ɐ k
아삭바삭	ɐ s ɐ k p͈ ɐ s ɐ k
아삭아삭	ɐ s ɐ k ɐ s ɐ k
아삼아삼	ɐ s ɐ m ɐ s ɐ m
아스스	ɐ s ɨ s ɨ
아슥아슥	ɐ s ɨ k ɐ s ɨ k
아슬랑아슬랑	ɐ s ɨ ɭ ɭ ɐ ŋ ɐ s ɨ ɭ ɭ ɐ ŋ
아슬아슬	ɐ s ɨ ɭ ɐ s ɨ ɭ
아슴아슴	ɐ s ɨ m ɐ s ɨ m
아슴푸레	ɐ s ɨ m pʰ u ɭ e
아싹	ɐ s͈ ɐ k
아싹아싹	ɐ s͈ ɐ k ɐ s͈ ɐ k
아쓱	ɐ s͈ ɨ k
아쓱아쓱	ɐ s͈ ɨ k ɐ s͈ ɨ k
아옹	ɐ o ŋ
아옹다옹	ɐ o ŋ t ɐ o ŋ
아옹아옹	ɐ o ŋ ɐ o ŋ
아웅다웅	ɐ u ŋ t ɐ u ŋ
아작	ɐ tɕ ɐ k
아작아작	ɐ tɕ ɐ k ɐ tɕ ɐ k
아장	ɐ tɕ ɐ ŋ
아장바장	ɐ tɕ ɐ ŋ p ɐ tɕ ɐ ŋ
아장아장	ɐ tɕ ɐ ŋ ɐ tɕ ɐ ŋ
아즐아즐	ɐ tɕ ɨ ɭ ɐ tɕ ɨ ɭ
아지직	ɐ tɕ i tɕ i k
아지직아지직	ɐ tɕ i tɕ i k ɐ tɕ i tɕ i k
아질아질	ɐ tɕ i ɭ ɐ tɕ i ɭ
아짝	ɐ tɕ͈ ɐ k
아짝아짝	ɐ tɕ͈ ɐ k ɐ tɕ͈ ɐ k
아찔	ɐ tɕ͈ i ɭ
아찔아찔	ɐ tɕ͈ i ɭ ɐ tɕ͈ i ɭ
아창아창	ɐ tɕʰ ɐ ŋ ɐ tɕʰ ɐ ŋ
아치랑아치랑	ɐ tɕʰ i ɭ ɐ ŋ ɐ tɕʰ i ɭ ɐ ŋ
아치장아치장	ɐ tɕʰ i tɕ ɐ ŋ ɐ tɕʰ i tɕ ɐ ŋ
아칫아칫	ɐ tɕʰ i s ɐ tɕʰ i t
아하하	ɐ ɐ h ɐ
안절부절	ɐ n tɕ ʌ ɭ p u tɕ ʌ ɭ
알근달근	ɐ ɭ k ɨ n t ɐ ɭ k ɨ n
알근알근	ɐ ɭ k ɨ n ɐ ɭ k ɨ n
알금삼삼	ɐ ɭ k ɨ m s ɐ m s ɐ m
알금솜솜	ɐ ɭ k ɨ m s o m s o m
알금알금	ɐ ɭ k ɨ m ɐ ɭ k ɨ m
알기살기	ɐ ɭ k i s ɐ ɭ k i
알뜰살뜰	ɐ ɭ t͈ ɨ ɭ s͈ ɐ ɭ t͈ ɨ ɭ
알라꿍달라꿍	ɐ ɭ ɭ ɐ k͈ u ŋ t ɐ ɭ ɭ ɐ k͈ u ŋ
알락달락	ɐ ɭ ɭ ɐ k t͈ ɐ ɭ ɭ ɐ k
알락알락	ɐ ɭ ɭ ɐ k ɐ ɭ ɭ ɐ k
알랑똥땅	ɐ ɭ ɭ ɐ ŋ t͈ o ŋ t͈ ɐ ŋ
알랑알랑	ɐ ɭ ɭ ɐ ŋ ɐ ɭ ɭ ɐ ŋ
알로록달로록	ɐ ɭ ɭ o ɭ o k t͈ ɐ ɭ ɭ o ɭ o k
알로록알로록	ɐ ɭ ɭ o ɭ o k ɐ ɭ ɭ o ɭ o k
알로롱달로롱	ɐ ɭ ɭ o ɭ o ŋ t ɐ ɭ ɭ o ɭ o ŋ
알로롱알로롱	ɐ ɭ ɭ o ɭ o ŋ ɐ ɭ ɭ o ɭ o ŋ
알롱달롱	ɐ ɭ ɭ o ŋ t ɐ ɭ ɭ o ŋ
알롱알롱	ɐ ɭ ɭ o ŋ ɐ ɭ ɭ o ŋ
알른알른	ɐ ɭ ɭ ɨ n ɐ ɭ ɭ ɨ n
알밋알밋	ɐ ɭ m i s ɐ ɭ m i t
알쏭달쏭	ɐ ɭ s͈ o ŋ t ɐ ɭ s͈ o ŋ
알쏭알쏭	ɐ ɭ s͈ o ŋ ɐ ɭ s͈ o ŋ
알씬	ɐ ɭ s͈ i n
알씬알씬	ɐ ɭ s͈ i n ɐ ɭ s͈ i n
알짱알짱	ɐ ɭ tɕ͈ ɐ ŋ ɐ ɭ tɕ͈ ɐ ŋ
알쫑알쫑	ɐ ɭ tɕ͈ o ŋ ɐ ɭ tɕ͈ o ŋ
알찐알찐	ɐ ɭ tɕ͈ i n ɐ ɭ tɕ͈ i n
알콩달콩	ɐ ɭ kʰ o ŋ t ɐ ɭ kʰ o ŋ
앍둑앍둑	ɐ k t͈ u k ɐ k t͈ u k
앍박앍박	ɐ k p͈ ɐ k ɐ k p͈ ɐ k
앍작앍작	ɐ k tɕ͈ ɐ k ɐ k tɕ͈ ɐ k
앍족앍족	ɐ k tɕ͈ o k ɐ k tɕ͈ o k
암니옴니	ɐ m n i o m n i
앙	ɐ ŋ
앙가조촘	ɐ ŋ k ɐ tɕ o tɕʰ o m
앙글방글	ɐ ŋ k ɨ ɭ p ɐ ŋ k ɨ ɭ
앙글앙글	ɐ ŋ k ɨ ɭ ɐ ŋ k ɨ ɭ
앙금쌀쌀	ɐ ŋ k ɨ m s͈ ɐ ɭ s͈ ɐ ɭ
앙금앙금	ɐ ŋ k ɨ m ɐ ŋ k ɨ m
앙기작앙기작	ɐ ŋ k i tɕ ɐ k ɐ ŋ k i tɕ ɐ k
앙당그레	ɐ ŋ t ɐ ŋ k ɨ ɭ e
앙실방실	ɐ ŋ s i ɭ p ɐ ŋ s i ɭ
앙알앙알	ɐ ŋ ɐ ɭ ɐ ŋ ɐ ɭ
앙앙	ɐ ŋ ɐ ŋ
앙잘앙잘	ɐ ŋ tɕ ɐ ɭ ɐ ŋ tɕ ɐ ɭ
앙큼상큼	ɐ ŋ kʰ ɨ m s ɐ ŋ kʰ ɨ m
앙큼앙큼	ɐ ŋ kʰ ɨ m ɐ ŋ kʰ ɨ m
애고대고	ɛ k o t ɛ k o
애고지고	ɛ k o tɕ i k o
애면글면	ɛ m j ʌ n k ɨ ɭ m j ʌ n
애해해	ɛ ɛ h ɛ
앵	ɛ ŋ
앵앵	ɛ ŋ ɛ ŋ
야금야금	j ɐ k ɨ m j ɐ k ɨ m
야긋야긋	j ɐ k ɨ s j ɐ k ɨ t
야기죽야기죽	j ɐ k i tɕ u k j ɐ k i tɕ u k
야드르르	j ɐ t ɨ ɭ ɨ ɭ ɨ
야들야들	j ɐ t ɨ ɭ j ɐ t ɨ ɭ
야리야리	j ɐ ɭ i j ɐ ɭ i
야릿야릿	j ɐ ɭ i s j ɐ ɭ i t
야물야물	j ɐ m u ɭ j ɐ m u ɭ
야불야불	j ɐ p u ɭ j ɐ p u ɭ
야스락야스락	j ɐ s ɨ ɭ ɐ k j ɐ s ɨ ɭ ɐ k
야옹	j ɐ o ŋ
야옹야옹	j ɐ o ŋ j ɐ o ŋ
야울야울	j ɐ u ɭ j ɐ u ɭ
얄긋얄긋	j ɐ ɭ k ɨ s j ɐ ɭ k ɨ t
얄기죽얄기죽	j ɐ ɭ k i tɕ u k j ɐ ɭ k i tɕ u k
얄깃얄깃	j ɐ ɭ k i s j ɐ ɭ k i t
얄랑얄랑	j ɐ ɭ ɭ ɐ ŋ j ɐ ɭ ɭ ɐ ŋ
얄쭉얄쭉	j ɐ ɭ tɕ͈ u k j ɐ ɭ tɕ͈ u k
얄찍얄찍	j ɐ ɭ tɕ͈ i k j ɐ ɭ tɕ͈ i k
얄팍얄팍	j ɐ ɭ pʰ ɐ k j ɐ ɭ pʰ ɐ k
양냥양냥	j ɐ ŋ n j ɐ ŋ j ɐ ŋ n j ɐ ŋ
양양	j ɐ ŋ j ɐ ŋ
어구구	ʌ k u k u
어귀어귀	ʌ k w i ʌ k w i
어근버근	ʌ k ɨ n p ʌ k ɨ n
어글어글	ʌ k ɨ ɭ ʌ k ɨ ɭ
어긋버긋	ʌ k ɨ t p͈ ʌ k ɨ t
어긋어긋	ʌ k ɨ s ʌ k ɨ t
어기뚱어기뚱	ʌ k i t͈ u ŋ ʌ k i t͈ u ŋ
어기적어기적	ʌ k i tɕ ʌ k ʌ k i tɕ ʌ k
어기죽어기죽	ʌ k i tɕ u k ʌ k i tɕ u k
어둑어둑	ʌ t u k ʌ t u k
어득어득	ʌ t ɨ k ʌ t ɨ k
어뜩비뜩	ʌ t͈ ɨ k p͈ i t͈ ɨ k
어뜩어뜩	ʌ t͈ ɨ k ʌ t͈ ɨ k
어런더런	ʌ ɭ ʌ n t ʌ ɭ ʌ n
어루룩더루룩	ʌ ɭ u ɭ u k t͈ ʌ ɭ u ɭ u k
어루룩어루룩	ʌ ɭ u ɭ u k ʌ ɭ u ɭ u k
어루룽더루룽	ʌ ɭ u ɭ u ŋ t ʌ ɭ u ɭ u ŋ
어루룽어루룽	ʌ ɭ u ɭ u ŋ ʌ ɭ u ɭ u ŋ
어루숭어루숭	ʌ ɭ u s u ŋ ʌ ɭ u s u ŋ
어룽더룽	ʌ ɭ u ŋ t ʌ ɭ u ŋ
어룽어룽	ʌ ɭ u ŋ ʌ ɭ u ŋ
어른어른	ʌ ɭ ɨ n ʌ ɭ ɨ n
어름더듬	ʌ ɭ ɨ m t ʌ t ɨ m
어름어름	ʌ ɭ ɨ m ʌ ɭ ɨ m
어름적어름적	ʌ ɭ ɨ m tɕ ʌ k ʌ ɭ ɨ m tɕ ʌ k
어리마리	ʌ ɭ i m ɐ ɭ i
어리바리	ʌ ɭ i p ɐ ɭ i
어리숭어리숭	ʌ ɭ i s u ŋ ʌ ɭ i s u ŋ
어리어리	ʌ ɭ i ʌ ɭ i
어릿어릿	ʌ ɭ i s ʌ ɭ i t
어물어물	ʌ m u ɭ ʌ m u ɭ
어물쩍	ʌ m u ɭ tɕ͈ ʌ k
어물쩍어물쩍	ʌ m u ɭ tɕ͈ ʌ k ʌ m u ɭ tɕ͈ ʌ k
어버버	ʌ p ʌ p ʌ
어벌쩡	ʌ p ʌ ɭ tɕ͈ ʌ ŋ
어빡자빡	ʌ p͈ ɐ k tɕ͈ ɐ p͈ ɐ k
어살버살	ʌ s ɐ ɭ p ʌ s ɐ ɭ
어석	ʌ s ʌ k
어석더석	ʌ s ʌ k t͈ ʌ s ʌ k
어석버석	ʌ s ʌ k p͈ ʌ s ʌ k
어석어석	ʌ s ʌ k ʌ s ʌ k
어슥어슥	ʌ s ɨ k ʌ s ɨ k
어슬렁어슬렁	ʌ s ɨ ɭ ɭ ʌ ŋ ʌ s ɨ ɭ ɭ ʌ ŋ
어슬어슬	ʌ s ɨ ɭ ʌ s ɨ ɭ
어슴푸레	ʌ s ɨ m pʰ u ɭ e
어슷비슷	ʌ s ɨ t p͈ i s ɨ t
어슷어슷	ʌ s ɨ s ʌ s ɨ t
어썩	ʌ s͈ ʌ k
어썩어썩	ʌ s͈ ʌ k ʌ s͈ ʌ k
어영부영	ʌ j ʌ ŋ p u j ʌ ŋ
어우렁더우렁	ʌ u ɭ ʌ ŋ t ʌ u ɭ ʌ ŋ
어적	ʌ tɕ ʌ k
어적어적	ʌ tɕ ʌ k ʌ tɕ ʌ k
어정버정	ʌ tɕ ʌ ŋ p ʌ tɕ ʌ ŋ
어정어정	ʌ tɕ ʌ ŋ ʌ tɕ ʌ ŋ
어정쩡	ʌ tɕ ʌ ŋ tɕ͈ ʌ ŋ
어질어질	ʌ tɕ i ɭ ʌ tɕ i ɭ
어쩌면	ʌ tɕ͈ ʌ m j ʌ n
어쩍	ʌ tɕ͈ ʌ k
어쩍어쩍	ʌ tɕ͈ ʌ k ʌ tɕ͈ ʌ k
어쩜	ʌ tɕ͈ ʌ m
어찔어찔	ʌ tɕ͈ i ɭ ʌ tɕ͈ i ɭ
어청어청	ʌ tɕʰ ʌ ŋ ʌ tɕʰ ʌ ŋ
어치렁어치렁	ʌ tɕʰ i ɭ ʌ ŋ ʌ tɕʰ i ɭ ʌ ŋ
어치정어치정	ʌ tɕʰ i tɕ ʌ ŋ ʌ tɕʰ i tɕ ʌ ŋ
어칠비칠	ʌ tɕʰ i ɭ p i tɕʰ i ɭ
어푸어푸	ʌ pʰ u ʌ pʰ u
어허허	ʌ ʌ h ʌ
어흥	ʌ ɨ ŋ
억박적박	ʌ k p͈ ɐ k tɕ͈ ʌ k p͈ ɐ k
억실억실	ʌ k s͈ i ɭ ʌ k s͈ i ɭ
억적박적	ʌ k tɕ͈ ʌ k p͈ ɐ k tɕ͈ ʌ k
억패듯	ʌ k pʰ ɛ t ɨ t
언뜻	ʌ n t͈ ɨ t
언뜻번뜻	ʌ n t͈ ɨ t p͈ ʌ n t͈ ɨ t
언뜻언뜻	ʌ n t͈ ɨ s ʌ n t͈ ɨ t
언죽번죽	ʌ n tɕ u k p͈ ʌ n tɕ u k
언틀먼틀	ʌ n tʰ ɨ ɭ m ʌ n tʰ ɨ ɭ
얼근덜근	ʌ ɭ k ɨ n t ʌ ɭ k ɨ n
얼근얼근	ʌ ɭ k ɨ n ʌ ɭ k ɨ n
얼금숨숨	ʌ ɭ k ɨ m s u m s u m
얼금얼금	ʌ ɭ k ɨ m ʌ ɭ k ɨ m
얼기설기	ʌ ɭ k i s ʌ ɭ k i
얼락녹을락	ʌ ɭ ɭ ɐ ŋ n o k ɨ ɭ ɭ ɐ k
얼락배락	ʌ ɭ ɭ ɐ k p͈ ɛ ɭ ɐ k
얼러꿍덜러꿍	ʌ ɭ ɭ ʌ k͈ u ŋ t ʌ ɭ ɭ ʌ k͈ u ŋ
얼럭덜럭	ʌ ɭ ɭ ʌ k t͈ ʌ ɭ ɭ ʌ k
얼럭얼럭	ʌ ɭ ɭ ʌ k ʌ ɭ ɭ ʌ k
얼렁뚱땅	ʌ ɭ ɭ ʌ ŋ t͈ u ŋ t͈ ɐ ŋ
얼렁얼렁	ʌ ɭ ɭ ʌ ŋ ʌ ɭ ɭ ʌ ŋ
얼루룩덜루룩	ʌ ɭ ɭ u ɭ u k t͈ ʌ ɭ ɭ u ɭ u k
얼루룩얼루룩	ʌ ɭ ɭ u ɭ u k ʌ ɭ ɭ u ɭ u k
얼루룽덜루룽	ʌ ɭ ɭ u ɭ u ŋ t ʌ ɭ ɭ u ɭ u ŋ
얼루룽얼루룽	ʌ ɭ ɭ u ɭ u ŋ ʌ ɭ ɭ u ɭ u ŋ
얼룽덜룽	ʌ ɭ ɭ u ŋ t ʌ ɭ ɭ u ŋ
얼룽얼룽	ʌ ɭ ɭ u ŋ ʌ ɭ ɭ u ŋ
얼른얼른	ʌ ɭ ɭ ɨ n ʌ ɭ ɭ ɨ n
얼멍덜멍	ʌ ɭ m ʌ ŋ t ʌ ɭ m ʌ ŋ
얼멍얼멍	ʌ ɭ m ʌ ŋ ʌ ɭ m ʌ ŋ
얼밋얼밋	ʌ ɭ m i s ʌ ɭ m i t
얼싸둥둥	ʌ ɭ s͈ ɐ t u ŋ t u ŋ
얼싸절싸	ʌ ɭ s͈ ɐ tɕ ʌ ɭ s͈ ɐ
얼쑹덜쑹	ʌ ɭ s͈ u ŋ t ʌ ɭ s͈ u ŋ
얼쑹얼쑹	ʌ ɭ s͈ u ŋ ʌ ɭ s͈ u ŋ
얼씬	ʌ ɭ s͈ i n
얼씬얼씬	ʌ ɭ s͈ i n ʌ ɭ s͈ i n
얼쩡얼쩡	ʌ ɭ tɕ͈ ʌ ŋ ʌ ɭ tɕ͈ ʌ ŋ
얼쭝얼쭝	ʌ ɭ tɕ͈ u ŋ ʌ ɭ tɕ͈ u ŋ
얼쯤	ʌ ɭ tɕ͈ ɨ m
얼쯤얼쯤	ʌ ɭ tɕ͈ ɨ m ʌ ɭ tɕ͈ ɨ m
얼찐얼찐	ʌ ɭ tɕ͈ i n ʌ ɭ tɕ͈ i n
얼키설키	ʌ ɭ kʰ i s ʌ ɭ kʰ i
얼핏	ʌ ɭ pʰ i t
얼핏얼핏	ʌ ɭ pʰ i s ʌ ɭ pʰ i t
얽둑얽둑	ʌ k t͈ u k ʌ k t͈ u k
얽벅얽벅	ʌ k p͈ ʌ k ʌ k p͈ ʌ k
얽적얽적	ʌ k tɕ͈ ʌ k ʌ k tɕ͈ ʌ k
얽죽얽죽	ʌ k tɕ͈ u k ʌ k tɕ͈ u k
엄벙덤벙	ʌ m p ʌ ŋ t ʌ m p ʌ ŋ
엄벙뗑	ʌ m p ʌ ŋ t͈ e ŋ
엄청	ʌ m tɕʰ ʌ ŋ
엉	ʌ ŋ
엉거주춤	ʌ ŋ k ʌ tɕ u tɕʰ u m
엉글벙글	ʌ ŋ k ɨ ɭ p ʌ ŋ k ɨ ɭ
엉글엉글	ʌ ŋ k ɨ ɭ ʌ ŋ k ɨ ɭ
엉금썰썰	ʌ ŋ k ɨ m s͈ ʌ ɭ s͈ ʌ ɭ
엉금엉금	ʌ ŋ k ɨ m ʌ ŋ k ɨ m
엉기성기	ʌ ŋ k i s ʌ ŋ k i
엉기적엉기적	ʌ ŋ k i tɕ ʌ k ʌ ŋ k i tɕ ʌ k
엉기정기	ʌ ŋ k i tɕ ʌ ŋ k i
엉두덜엉두덜	ʌ ŋ t u t ʌ ɭ ʌ ŋ t u t ʌ ɭ
엉벙	ʌ ŋ p ʌ ŋ
엉얼엉얼	ʌ ŋ ʌ ɭ ʌ ŋ ʌ ɭ
엉엉	ʌ ŋ ʌ ŋ
엉이야벙이야	ʌ ŋ i j ɐ p ʌ ŋ i j ɐ
엉절엉절	ʌ ŋ tɕ ʌ ɭ ʌ ŋ tɕ ʌ ɭ
엉정벙정	ʌ ŋ tɕ ʌ ŋ p ʌ ŋ tɕ ʌ ŋ
엉큼성큼	ʌ ŋ kʰ ɨ m s ʌ ŋ kʰ ɨ m
엉큼엉큼	ʌ ŋ kʰ ɨ m ʌ ŋ kʰ ɨ m
엎치락덮치락	ʌ p tɕʰ i ɭ ɐ k t͈ ʌ p tɕʰ i ɭ ɐ k
엎치락뒤치락	ʌ p tɕʰ i ɭ ɐ k t͈ w i tɕʰ i ɭ ɐ k
엎치락잦히락	ʌ p tɕʰ i ɭ ɐ k tɕ͈ ɐ tɕʰ i ɭ ɐ k
에구데구	e k u t e k u
에멜무지로	e m e ɭ m u tɕ i ɭ o
에부수수	e p u s u s u
에취	e tɕʰ w i
에푸수수	e pʰ u s u s u
여릿여릿	j ʌ ɭ i s j ʌ ɭ i t
여싯여싯	j ʌ s i s j ʌ s i t
여울여울	j ʌ u ɭ j ʌ u ɭ
여짓여짓	j ʌ tɕ i s j ʌ tɕ i t
여흘여흘	j ʌ ɨ ɭ j ʌ ɨ ɭ
열렁열렁	j ʌ ɭ ɭ ʌ ŋ j ʌ ɭ ɭ ʌ ŋ
오구작작	o k u tɕ ɐ k tɕ͈ ɐ k
오그랑오그랑	o k ɨ ɭ ɐ ŋ o k ɨ ɭ ɐ ŋ
오그랑쪼그랑	o k ɨ ɭ ɐ ŋ tɕ͈ o k ɨ ɭ ɐ ŋ
오그르르	o k ɨ ɭ ɨ ɭ ɨ
오글보글	o k ɨ ɭ p o k ɨ ɭ
오글오글	o k ɨ ɭ o k ɨ ɭ
오글자글	o k ɨ ɭ tɕ ɐ k ɨ ɭ
오긋오긋	o k ɨ s o k ɨ t
오도당	o t o t ɐ ŋ
오도당오도당	o t o t ɐ ŋ o t o t ɐ ŋ
오도독	o t o t o k
오도독오도독	o t o t o k o t o t o k
오도카니	o t o kʰ ɐ n i
오돌오돌	o t o ɭ o t o ɭ
오돌토돌	o t o ɭ tʰ o t o ɭ
오동보동	o t o ŋ p o t o ŋ
오동통	o t o ŋ tʰ o ŋ
오동포동	o t o ŋ pʰ o t o ŋ
오들오들	o t ɨ ɭ o t ɨ ɭ
오똘오똘	o t͈ o ɭ o t͈ o ɭ
오뚝	o t͈ u k
오뚝오뚝	o t͈ u k o t͈ u k
오락가락	o ɭ ɐ k k͈ ɐ ɭ ɐ k
오롱조롱	o ɭ o ŋ tɕ o ɭ o ŋ
오르락내리락	o ɭ ɨ ɭ ɐ ŋ n ɛ ɭ i ɭ ɐ k
오르르	o ɭ ɨ ɭ ɨ
오리가리	o ɭ i k ɐ ɭ i
오막조막	o m ɐ k tɕ͈ o m ɐ k
오목	o m o k
오목오목	o m o k o m o k
오목조목	o m o k tɕ͈ o m o k
오무락오무락	o m u ɭ ɐ k o m u ɭ ɐ k
오무작오무작	o m u tɕ ɐ k o m u tɕ ɐ k
오물오물	o m u ɭ o m u ɭ
오물쪼물	o m u ɭ tɕ͈ o m u ɭ
오복소복	o p o k s͈ o p o k
오복조르듯	o p o k tɕ͈ o ɭ ɨ t ɨ t
오불고불	o p u ɭ k o p u ɭ
오불꼬불	o p u ɭ k͈ o p u ɭ
오불오불	o p u ɭ o p u ɭ
오불조불	o p u ɭ tɕ o p u ɭ
오비작오비작	o p i tɕ ɐ k o p i tɕ ɐ k
오빗오빗	o p i s o p i t
오삭오삭	o s ɐ k o s ɐ k
오소소	o s o s o
오손도손	o s o n t o s o n
오순도순	o s u n t o s u n
오스스	o s ɨ s ɨ
오슬오슬	o s ɨ ɭ o s ɨ ɭ
오싹	o s͈ ɐ k
오싹오싹	o s͈ ɐ k o s͈ ɐ k
오작오작	o tɕ ɐ k o tɕ ɐ k
오졸오졸	o tɕ o ɭ o tɕ o ɭ
오지끈	o tɕ i k͈ ɨ n
오지끈똑딱	o tɕ i k͈ ɨ n t͈ o k t͈ ɐ k
오지끈오지끈	o tɕ i k͈ ɨ n o tɕ i k͈ ɨ n
오지직	o tɕ i tɕ i k
오지직오지직	o tɕ i tɕ i k o tɕ i tɕ i k
오직오직	o tɕ i k o tɕ i k
오짝오짝	o tɕ͈ ɐ k o tɕ͈ ɐ k
오쫄오쫄	o tɕ͈ o ɭ o tɕ͈ o ɭ
오톨도톨	o tʰ o ɭ t o tʰ o ɭ
오호호	o o h o
옥시글옥시글	o k s͈ i k ɨ ɭ o k s͈ i k ɨ ɭ
옥신옥신	o k s͈ i n o k s͈ i n
옥실옥실	o k s͈ i ɭ o k s͈ i ɭ
옥작복작	o k tɕ͈ ɐ k p͈ o k tɕ͈ ɐ k
옥작옥작	o k tɕ͈ ɐ k o k tɕ͈ ɐ k
올각	o ɭ k ɐ k
올각올각	o ɭ k ɐ k o ɭ k ɐ k
올강볼강	o ɭ k ɐ ŋ p o ɭ k ɐ ŋ
올강올강	o ɭ k ɐ ŋ o ɭ k ɐ ŋ
올공볼공	o ɭ k o ŋ p o ɭ k o ŋ
올공올공	o ɭ k o ŋ o ɭ k o ŋ
올근볼근	o ɭ k ɨ n p o ɭ k ɨ n
올근올근	o ɭ k ɨ n o ɭ k ɨ n
올긋볼긋	o ɭ k ɨ t p͈ o ɭ k ɨ t
올깍	o ɭ k͈ ɐ k
올깍올깍	o ɭ k͈ ɐ k o ɭ k͈ ɐ k
올딱	o ɭ t͈ ɐ k
올딱올딱	o ɭ t͈ ɐ k o ɭ t͈ ɐ k
올똑볼똑	o ɭ t͈ o k p͈ o ɭ t͈ o k
올랑올랑	o ɭ ɭ ɐ ŋ o ɭ ɭ ɐ ŋ
올랑촐랑	o ɭ ɭ ɐ ŋ tɕʰ o ɭ ɭ ɐ ŋ
올록볼록	o ɭ ɭ o k p͈ o ɭ ɭ o k
올막졸막	o ɭ m ɐ k tɕ͈ o ɭ m ɐ k
올망졸망	o ɭ m ɐ ŋ tɕ o ɭ m ɐ ŋ
올목졸목	o ɭ m o k tɕ͈ o ɭ m o k
올몽졸몽	o ɭ m o ŋ tɕ o ɭ m o ŋ
올쏙볼쏙	o ɭ s͈ o k p͈ o ɭ s͈ o k
올올	o ɭ o ɭ
올칵	o ɭ kʰ ɐ k
올칵올칵	o ɭ kʰ ɐ k o ɭ kʰ ɐ k
올톡볼톡	o ɭ tʰ o k p͈ o ɭ tʰ o k
올통볼통	o ɭ tʰ o ŋ p o ɭ tʰ o ŋ
옴실옴실	o m s i ɭ o m s i ɭ
옴쏙	o m s͈ o k
옴쏙옴쏙	o m s͈ o k o m s͈ o k
옴씰	o m s͈ i ɭ
옴씰옴씰	o m s͈ i ɭ o m s͈ i ɭ
옴죽	o m tɕ u k
옴죽옴죽	o m tɕ u k o m tɕ u k
옴지락옴지락	o m tɕ i ɭ ɐ k o m tɕ i ɭ ɐ k
옴직옴직	o m tɕ i k o m tɕ i k
옴질옴질	o m tɕ i ɭ o m tɕ i ɭ
옴짝	o m tɕ͈ ɐ k
옴짝달싹	o m tɕ͈ ɐ k t͈ ɐ ɭ s͈ ɐ k
옴짝옴짝	o m tɕ͈ ɐ k o m tɕ͈ ɐ k
옴쭉	o m tɕ͈ u k
옴쭉옴쭉	o m tɕ͈ u k o m tɕ͈ u k
옴찍옴찍	o m tɕ͈ i k o m tɕ͈ i k
옴찔	o m tɕ͈ i ɭ
옴찔옴찔	o m tɕ͈ i ɭ o m tɕ͈ i ɭ
옴칠	o m tɕʰ i ɭ
옴칠옴칠	o m tɕʰ i ɭ o m tɕʰ i ɭ
옴칫	o m tɕʰ i t
옴칫옴칫	o m tɕʰ i s o m tɕʰ i t
옴팍	o m pʰ ɐ k
옴팍옴팍	o m pʰ ɐ k o m pʰ ɐ k
옴폭	o m pʰ o k
옴폭옴폭	o m pʰ o k o m pʰ o k
옹긋옹긋	o ŋ k ɨ s o ŋ k ɨ t
옹긋쫑긋	o ŋ k ɨ t tɕ͈ o ŋ k ɨ t
옹기옹기	o ŋ k i o ŋ k i
옹기종기	o ŋ k i tɕ o ŋ k i
옹성옹성	o ŋ s ʌ ŋ o ŋ s ʌ ŋ
옹송망송	o ŋ s o ŋ m ɐ ŋ s o ŋ
옹알옹알	o ŋ ɐ ɭ o ŋ ɐ ɭ
옹잘옹잘	o ŋ tɕ ɐ ɭ o ŋ tɕ ɐ ɭ
와	w ɐ
와각와각	w ɐ k ɐ k w ɐ k ɐ k
와그그	w ɐ k ɨ k ɨ
와그르르	w ɐ k ɨ ɭ ɨ ɭ ɨ
와그작와그작	w ɐ k ɨ tɕ ɐ k w ɐ k ɨ tɕ ɐ k
와글와글	w ɐ k ɨ ɭ w ɐ k ɨ ɭ
와다닥	w ɐ t ɐ t ɐ k
와다닥와다닥	w ɐ t ɐ t ɐ k w ɐ t ɐ t ɐ k
와닥닥	w ɐ t ɐ k t͈ ɐ k
와닥닥와닥닥	w ɐ t ɐ k t͈ ɐ k w ɐ t ɐ k t͈ ɐ k
와당와당	w ɐ t ɐ ŋ w ɐ t ɐ ŋ
와당탕	w ɐ t ɐ ŋ tʰ ɐ ŋ
와당탕와당탕	w ɐ t ɐ ŋ tʰ ɐ ŋ w ɐ t ɐ ŋ tʰ ɐ ŋ
와당탕퉁탕	w ɐ t ɐ ŋ tʰ ɐ ŋ tʰ u ŋ tʰ ɐ ŋ
와드득	w ɐ t ɨ t ɨ k
와드득와드득	w ɐ t ɨ t ɨ k w ɐ t ɨ t ɨ k
와드등와드등	w ɐ t ɨ t ɨ ŋ w ɐ t ɨ t ɨ ŋ
와들와들	w ɐ t ɨ ɭ w ɐ t ɨ ɭ
와락	w ɐ ɭ ɐ k
와락와락	w ɐ ɭ ɐ k w ɐ ɭ ɐ k
와르르	w ɐ ɭ ɨ ɭ ɨ
와르르와르르	w ɐ ɭ ɨ ɭ ɨ w ɐ ɭ ɨ ɭ ɨ
와르릉	w ɐ ɭ ɨ ɭ ɨ ŋ
와르릉와르릉	w ɐ ɭ ɨ ɭ ɨ ŋ w ɐ ɭ ɨ ɭ ɨ ŋ
와릉와릉	w ɐ ɭ ɨ ŋ w ɐ ɭ ɨ ŋ
와삭	w ɐ s ɐ k
와삭바삭	w ɐ s ɐ k p͈ ɐ s ɐ k
와삭와삭	w ɐ s ɐ k w ɐ s ɐ k
와스스	w ɐ s ɨ s ɨ
와스스와스스	w ɐ s ɨ s ɨ w ɐ s ɨ s ɨ
와싹	w ɐ s͈ ɐ k
와싹와싹	w ɐ s͈ ɐ k w ɐ s͈ ɐ k
와와	w ɐ w ɐ
와작	w ɐ tɕ ɐ k
와작와작	w ɐ tɕ ɐ k w ɐ tɕ ɐ k
와장창	w ɐ tɕ ɐ ŋ tɕʰ ɐ ŋ
와지끈	w ɐ tɕ i k͈ ɨ n
와지끈뚝딱	w ɐ tɕ i k͈ ɨ n t͈ u k t͈ ɐ k
와지끈와지끈	w ɐ tɕ i k͈ ɨ n w ɐ tɕ i k͈ ɨ n
와지끈자끈	w ɐ tɕ i k͈ ɨ n tɕ ɐ k͈ ɨ n
와짝	w ɐ tɕ͈ ɐ k
와짝와짝	w ɐ tɕ͈ ɐ k w ɐ tɕ͈ ɐ k
와하하	w ɐ ɐ h ɐ
왁	w ɐ k
왁다그르르	w ɐ k t͈ ɐ k ɨ ɭ ɨ ɭ ɨ
왁다글닥다글	w ɐ k t͈ ɐ k ɨ ɭ t ɐ k t͈ ɐ k ɨ ɭ
왁다글왁다글	w ɐ k t͈ ɐ k ɨ ɭ w ɐ k t͈ ɐ k ɨ ɭ
왁달박달	w ɐ k t͈ ɐ ɭ p ɐ k t͈ ɐ ɭ
왁시글덕시글	w ɐ k s͈ i k ɨ ɭ t ʌ k s͈ i k ɨ ɭ
왁시글왁시글	w ɐ k s͈ i k ɨ ɭ w ɐ k s͈ i k ɨ ɭ
왁왁	w ɐ k w ɐ k
왁자	w ɐ k tɕ͈ ɐ
왁자그르르	w ɐ k tɕ͈ ɐ k ɨ ɭ ɨ ɭ ɨ
왁자글	w ɐ k tɕ͈ ɐ k ɨ ɭ
왁자글왁자글	w ɐ k tɕ͈ ɐ k ɨ ɭ w ɐ k tɕ͈ ɐ k ɨ ɭ
왁자지껄	w ɐ k tɕ͈ ɐ tɕ i k͈ ʌ ɭ
왁작	w ɐ k tɕ͈ ɐ k
왁작박작	w ɐ k tɕ͈ ɐ k p͈ ɐ k tɕ͈ ɐ k
왁작왁작	w ɐ k tɕ͈ ɐ k w ɐ k tɕ͈ ɐ k
왈가닥	w ɐ ɭ k ɐ t ɐ k
왈가닥달가닥	w ɐ ɭ k ɐ t ɐ k t͈ ɐ ɭ k ɐ t ɐ k
왈가닥왈가닥	w ɐ ɭ k ɐ t ɐ k w ɐ ɭ k ɐ t ɐ k
왈강	w ɐ ɭ k ɐ ŋ
왈강달강	w ɐ ɭ k ɐ ŋ t ɐ ɭ k ɐ ŋ
왈강왈강	w ɐ ɭ k ɐ ŋ w ɐ ɭ k ɐ ŋ
왈그륵달그륵	w ɐ ɭ k ɨ ɭ ɨ k t͈ ɐ ɭ k ɨ ɭ ɨ k
왈딱	w ɐ ɭ t͈ ɐ k
왈딱왈딱	w ɐ ɭ t͈ ɐ k w ɐ ɭ t͈ ɐ k
왈랑절렁	w ɐ ɭ ɭ ɐ ŋ tɕ ʌ ɭ ɭ ʌ ŋ
왈랑철렁	w ɐ ɭ ɭ ɐ ŋ tɕʰ ʌ ɭ ɭ ʌ ŋ
왈왈	w ɐ ɭ w ɐ ɭ
왈카닥	w ɐ ɭ kʰ ɐ t ɐ k
왈카닥달카닥	w ɐ ɭ kʰ ɐ t ɐ k t͈ ɐ ɭ kʰ ɐ t ɐ k
왈카닥왈카닥	w ɐ ɭ kʰ ɐ t ɐ k w ɐ ɭ kʰ ɐ t ɐ k
왈캉	w ɐ ɭ kʰ ɐ ŋ
왈캉달캉	w ɐ ɭ kʰ ɐ ŋ t ɐ ɭ kʰ ɐ ŋ
왈캉왈캉	w ɐ ɭ kʰ ɐ ŋ w ɐ ɭ kʰ ɐ ŋ
왕	w ɐ ŋ
왕배덕배	w ɐ ŋ p ɛ t ʌ k p͈ ɛ
왕왕	w ɐ ŋ w ɐ ŋ
왜각대각	w ɛ k ɐ k t͈ ɛ k ɐ k
왜그르르	w ɛ k ɨ ɭ ɨ ɭ ɨ
왜글왜글	w ɛ k ɨ ɭ w ɛ k ɨ ɭ
왜깍대깍	w ɛ k͈ ɐ k t͈ ɛ k͈ ɐ k
왜뚜	w ɛ t͈ u
왜뚤비뚤	w ɛ t͈ u ɭ p i t͈ u ɭ
왜뚤삐뚤	w ɛ t͈ u ɭ p͈ i t͈ u ɭ
왜뚤왜뚤	w ɛ t͈ u ɭ w ɛ t͈ u ɭ
왜왜	w ɛ w ɛ
왜죽왜죽	w ɛ tɕ u k w ɛ tɕ u k
왜쭉비쭉	w ɛ tɕ͈ u k p͈ i tɕ͈ u k
왜쭉왜쭉	w ɛ tɕ͈ u k w ɛ tɕ͈ u k
왜틀비틀	w ɛ tʰ ɨ ɭ p i tʰ ɨ ɭ
왝	w ɛ k
왝왝	w ɛ k w ɛ k
왱	w ɛ ŋ
왱강왱강	w ɛ ŋ k ɐ ŋ w ɛ ŋ k ɐ ŋ
왱강쟁강	w ɛ ŋ k ɐ ŋ tɕ ɛ ŋ k ɐ ŋ
왱그랑	w ɛ ŋ k ɨ ɭ ɐ ŋ
왱그랑댕그랑	w ɛ ŋ k ɨ ɭ ɐ ŋ t ɛ ŋ k ɨ ɭ ɐ ŋ
왱그랑왱그랑	w ɛ ŋ k ɨ ɭ ɐ ŋ w ɛ ŋ k ɨ ɭ ɐ ŋ
왱댕	w ɛ ŋ t ɛ ŋ
왱댕그랑	w ɛ ŋ t ɛ ŋ k ɨ ɭ ɐ ŋ
왱왱	w ɛ ŋ w ɛ ŋ
욍	w e ŋ
욍욍	w e ŋ w e ŋ
요러쿵조러쿵	j o ɭ ʌ kʰ u ŋ tɕ o ɭ ʌ kʰ u ŋ
요리	j o ɭ i
요리요리	j o ɭ i j o ɭ i
요리조리	j o ɭ i tɕ o ɭ i
요리쿵조리쿵	j o ɭ i kʰ u ŋ tɕ o ɭ i kʰ u ŋ
욜랑욜랑	j o ɭ ɭ ɐ ŋ j o ɭ ɭ ɐ ŋ
우	u
우걱우걱	u k ʌ k u k ʌ k
우걱지걱	u k ʌ k tɕ͈ i k ʌ k
우그그	u k ɨ k ɨ
우그렁우그렁	u k ɨ ɭ ʌ ŋ u k ɨ ɭ ʌ ŋ
우그렁쭈그렁	u k ɨ ɭ ʌ ŋ tɕ͈ u k ɨ ɭ ʌ ŋ
우그르르	u k ɨ ɭ ɨ ɭ ɨ
우글부글	u k ɨ ɭ p u k ɨ ɭ
우글우글	u k ɨ ɭ u k ɨ ɭ
우글지글	u k ɨ ɭ tɕ i k ɨ ɭ
우긋우긋	u k ɨ s u k ɨ t
우꾼우꾼	u k͈ u n u k͈ u n
우네부네	u n e p u n e
우당탕	u t ɐ ŋ tʰ ɐ ŋ
우당탕우당탕	u t ɐ ŋ tʰ ɐ ŋ u t ɐ ŋ tʰ ɐ ŋ
우당탕퉁탕	u t ɐ ŋ tʰ ɐ ŋ tʰ u ŋ tʰ ɐ ŋ
우당퉁탕	u t ɐ ŋ tʰ u ŋ tʰ ɐ ŋ
우두덩	u t u t ʌ ŋ
우두덩우두덩	u t u t ʌ ŋ u t u t ʌ ŋ
우두둑	u t u t u k
우두둑우두둑	u t u t u k u t u t u k
우두망절	u t u m ɐ ŋ tɕ ʌ ɭ
우두망찰	u t u m ɐ ŋ tɕʰ ɐ ɭ
우두커니	u t u kʰ ʌ n i
우둔우둔	u t u n u t u n
우둘우둘	u t u ɭ u t u ɭ
우둘투둘	u t u ɭ tʰ u t u ɭ
우둥부둥	u t u ŋ p u t u ŋ
우둥우둥	u t u ŋ u t u ŋ
우둥퉁	u t u ŋ tʰ u ŋ
우둥푸둥	u t u ŋ pʰ u t u ŋ
우들우들	u t ɨ ɭ u t ɨ ɭ
우뚝	u t͈ u k
우뚝우뚝	u t͈ u k u t͈ u k
우뚤우뚤	u t͈ u ɭ u t͈ u ɭ
우락부락	u ɭ ɐ k p͈ u ɭ ɐ k
우럭우럭	u ɭ ʌ k u ɭ ʌ k
우렁우렁	u ɭ ʌ ŋ u ɭ ʌ ŋ
우르르	u ɭ ɨ ɭ ɨ
우르릉	u ɭ ɨ ɭ ɨ ŋ
우르릉우르릉	u ɭ ɨ ɭ ɨ ŋ u ɭ ɨ ɭ ɨ ŋ
우무럭우무럭	u m u ɭ ʌ k u m u ɭ ʌ k
우무적우무적	u m u tɕ ʌ k u m u tɕ ʌ k
우묵	u m u k
우묵우묵	u m u k u m u k
우묵주묵	u m u k tɕ͈ u m u k
우물우물	u m u ɭ u m u ɭ
우물쩍	u m u ɭ tɕ͈ ʌ k
우물쩍우물쩍	u m u ɭ tɕ͈ ʌ k u m u ɭ tɕ͈ ʌ k
우물쩍주물쩍	u m u ɭ tɕ͈ ʌ k tɕ͈ u m u ɭ tɕ͈ ʌ k
우물쭈물	u m u ɭ tɕ͈ u m u ɭ
우북수북	u p u k s͈ u p u k
우불구불	u p u ɭ k u p u ɭ
우불꾸불	u p u ɭ k͈ u p u ɭ
우비적우비적	u p i tɕ ʌ k u p i tɕ ʌ k
우빗우빗	u p i s u p i t
우수수	u s u s u
우썩	u s͈ ʌ k
우썩우썩	u s͈ ʌ k u s͈ ʌ k
우우	u u
우적	u tɕ ʌ k
우적우적	u tɕ ʌ k u tɕ ʌ k
우죽우죽	u tɕ u k u tɕ u k
우줄우줄	u tɕ u ɭ u tɕ u ɭ
우줅우줅	u tɕ u ɭ k u tɕ u k
우중우중	u tɕ u ŋ u tɕ u ŋ
우중충	u tɕ u ŋ tɕʰ u ŋ
우지끈	u tɕ i k͈ ɨ n
우지끈뚝딱	u tɕ i k͈ ɨ n t͈ u k t͈ ɐ k
우지끈우지끈	u tɕ i k͈ ɨ n u tɕ i k͈ ɨ n
우지직	u tɕ i tɕ i k
우지직우지직	u tɕ i tɕ i k u tɕ i tɕ i k
우직우직	u tɕ i k u tɕ i k
우질부질	u tɕ i ɭ p u tɕ i ɭ
우쩍	u tɕ͈ ʌ k
우쩍우쩍	u tɕ͈ ʌ k u tɕ͈ ʌ k
우쭉우쭉	u tɕ͈ u k u tɕ͈ u k
우쭐	u tɕ͈ u ɭ
우쭐우쭐	u tɕ͈ u ɭ u tɕ͈ u ɭ
우툴두툴	u tʰ u ɭ t u tʰ u ɭ
우툴우툴	u tʰ u ɭ u tʰ u ɭ
욱	u k
욱닥욱닥	u k t͈ ɐ k u k t͈ ɐ k
욱시글득시글	u k s͈ i k ɨ ɭ t ɨ k s͈ i k ɨ ɭ
욱시글욱시글	u k s͈ i k ɨ ɭ u k s͈ i k ɨ ɭ
욱신덕신	u k s͈ i n t ʌ k s͈ i n
욱신욱신	u k s͈ i n u k s͈ i n
욱적	u k tɕ͈ ʌ k
욱적북적	u k tɕ͈ ʌ k p͈ u k tɕ͈ ʌ k
욱적욱적	u k tɕ͈ ʌ k u k tɕ͈ ʌ k
울걱	u ɭ k ʌ k
울걱울걱	u ɭ k ʌ k u ɭ k ʌ k
울겅불겅	u ɭ k ʌ ŋ p u ɭ k ʌ ŋ
울겅울겅	u ɭ k ʌ ŋ u ɭ k ʌ ŋ
울고불고	u ɭ k o p u ɭ k o
울근불근	u ɭ k ɨ n p u ɭ k ɨ n
울근울근	u ɭ k ɨ n u ɭ k ɨ n
울긋불긋	u ɭ k ɨ t p͈ u ɭ k ɨ t
울꺽	u ɭ k͈ ʌ k
울꺽울꺽	u ɭ k͈ ʌ k u ɭ k͈ ʌ k
울뚝	u ɭ t͈ u k
울뚝불뚝	u ɭ t͈ u k p͈ u ɭ t͈ u k
울뚝울뚝	u ɭ t͈ u k u ɭ t͈ u k
울렁울렁	u ɭ ɭ ʌ ŋ u ɭ ɭ ʌ ŋ
울렁출렁	u ɭ ɭ ʌ ŋ tɕʰ u ɭ ɭ ʌ ŋ
울레줄레	u ɭ ɭ e tɕ u ɭ ɭ e
울룩불룩	u ɭ ɭ u k p͈ u ɭ ɭ u k
울먹울먹	u ɭ m ʌ k u ɭ m ʌ k
울먹줄먹	u ɭ m ʌ k tɕ͈ u ɭ m ʌ k
울멍줄멍	u ɭ m ʌ ŋ tɕ u ɭ m ʌ ŋ
울며불며	u ɭ m j ʌ p u ɭ m j ʌ
울묵줄묵	u ɭ m u k tɕ͈ u ɭ m u k
울뭉줄뭉	u ɭ m u ŋ tɕ u ɭ m u ŋ
울쑥불쑥	u ɭ s͈ u k p͈ u ɭ s͈ u k
울컥	u ɭ kʰ ʌ k
울컥울컥	u ɭ kʰ ʌ k u ɭ kʰ ʌ k
울툭불툭	u ɭ tʰ u k p͈ u ɭ tʰ u k
울퉁불퉁	u ɭ tʰ u ŋ p u ɭ tʰ u ŋ
움실움실	u m s i ɭ u m s i ɭ
움쑥	u m s͈ u k
움쑥움쑥	u m s͈ u k u m s͈ u k
움씰	u m s͈ i ɭ
움씰움씰	u m s͈ i ɭ u m s͈ i ɭ
움죽	u m tɕ u k
움죽움죽	u m tɕ u k u m tɕ u k
움지럭움지럭	u m tɕ i ɭ ʌ k u m tɕ i ɭ ʌ k
움직움직	u m tɕ i k u m tɕ i k
움질움질	u m tɕ i ɭ u m tɕ i ɭ
움쩍	u m tɕ͈ ʌ k
움쩍달싹	u m tɕ͈ ʌ k t͈ ɐ ɭ s͈ ɐ k
움쩍들썩	u m tɕ͈ ʌ k t͈ ɨ ɭ s͈ ʌ k
움쩍움쩍	u m tɕ͈ ʌ k u m tɕ͈ ʌ k
움쭉	u m tɕ͈ u k
움쭉달싹	u m tɕ͈ u k t͈ ɐ ɭ s͈ ɐ k
움쭉움쭉	u m tɕ͈ u k u m tɕ͈ u k
움찍움찍	u m tɕ͈ i k u m tɕ͈ i k
움찔	u m tɕ͈ i ɭ
움찔움찔	u m tɕ͈ i ɭ u m tɕ͈ i ɭ
움칠	u m tɕʰ i ɭ
움칠움칠	u m tɕʰ i ɭ u m tɕʰ i ɭ
움칫	u m tɕʰ i t
움칫움칫	u m tɕʰ i s u m tɕʰ i t
움퍽	u m pʰ ʌ k
움퍽움퍽	u m pʰ ʌ k u m pʰ ʌ k
움푹	u m pʰ u k
움푹움푹	u m pʰ u k u m pʰ u k
웅게웅게	u ŋ k e u ŋ k e
웅긋웅긋	u ŋ k ɨ s u ŋ k ɨ t
웅긋중긋	u ŋ k ɨ t tɕ͈ u ŋ k ɨ t
웅긋쭝긋	u ŋ k ɨ t tɕ͈ u ŋ k ɨ t
웅기웅기	u ŋ k i u ŋ k i
웅기중기	u ŋ k i tɕ u ŋ k i
웅성웅성	u ŋ s ʌ ŋ u ŋ s ʌ ŋ
웅얼웅얼	u ŋ ʌ ɭ u ŋ ʌ ɭ
웅절웅절	u ŋ tɕ ʌ ɭ u ŋ tɕ ʌ ɭ
워걱워걱	w ʌ k ʌ k w ʌ k ʌ k
워그르르	w ʌ k ɨ ɭ ɨ ɭ ɨ
워그적워그적	w ʌ k ɨ tɕ ʌ k w ʌ k ɨ tɕ ʌ k
워글워글	w ʌ k ɨ ɭ w ʌ k ɨ ɭ
워럭	w ʌ ɭ ʌ k
워럭워럭	w ʌ ɭ ʌ k w ʌ ɭ ʌ k
워르르	w ʌ ɭ ɨ ɭ ɨ
워석	w ʌ s ʌ k
워석버석	w ʌ s ʌ k p͈ ʌ s ʌ k
워석워석	w ʌ s ʌ k w ʌ s ʌ k
워썩	w ʌ s͈ ʌ k
워썩워썩	w ʌ s͈ ʌ k w ʌ s͈ ʌ k
웍더그르르	w ʌ k t͈ ʌ k ɨ ɭ ɨ ɭ ɨ
웍더글덕더글	w ʌ k t͈ ʌ k ɨ ɭ t ʌ k t͈ ʌ k ɨ ɭ
웍더글웍더글	w ʌ k t͈ ʌ k ɨ ɭ w ʌ k t͈ ʌ k ɨ ɭ
웍저그르르	w ʌ k tɕ͈ ʌ k ɨ ɭ ɨ ɭ ɨ
월거덕	w ʌ ɭ k ʌ t ʌ k
월거덕덜거덕	w ʌ ɭ k ʌ t ʌ k t͈ ʌ ɭ k ʌ t ʌ k
월거덕월거덕	w ʌ ɭ k ʌ t ʌ k w ʌ ɭ k ʌ t ʌ k
월겅	w ʌ ɭ k ʌ ŋ
월겅덜겅	w ʌ ɭ k ʌ ŋ t ʌ ɭ k ʌ ŋ
월겅월겅	w ʌ ɭ k ʌ ŋ w ʌ ɭ k ʌ ŋ
월떡	w ʌ ɭ t͈ ʌ k
월떡월떡	w ʌ ɭ t͈ ʌ k w ʌ ɭ t͈ ʌ k
월커덕	w ʌ ɭ kʰ ʌ t ʌ k
월커덕덜커덕	w ʌ ɭ kʰ ʌ t ʌ k t͈ ʌ ɭ kʰ ʌ t ʌ k
월커덕월커덕	w ʌ ɭ kʰ ʌ t ʌ k w ʌ ɭ kʰ ʌ t ʌ k
월컹	w ʌ ɭ kʰ ʌ ŋ
월컹덜컹	w ʌ ɭ kʰ ʌ ŋ t ʌ ɭ kʰ ʌ ŋ
월컹월컹	w ʌ ɭ kʰ ʌ ŋ w ʌ ɭ kʰ ʌ ŋ
웨죽웨죽	w e tɕ u k w e tɕ u k
웩	w e k
웩웩	w e k w e k
웽	w e ŋ
웽겅웽겅	w e ŋ k ʌ ŋ w e ŋ k ʌ ŋ
웽겅젱겅	w e ŋ k ʌ ŋ tɕ e ŋ k ʌ ŋ
웽그렁	w e ŋ k ɨ ɭ ʌ ŋ
웽그렁뎅그렁	w e ŋ k ɨ ɭ ʌ ŋ t e ŋ k ɨ ɭ ʌ ŋ
웽그렁웽그렁	w e ŋ k ɨ ɭ ʌ ŋ w e ŋ k ɨ ɭ ʌ ŋ
웽웽	w e ŋ w e ŋ
위룽튀룽	w i ɭ u ŋ tʰ w i ɭ u ŋ
윙	w i ŋ
윙윙	w i ŋ w i ŋ
유들유들	j u t ɨ ɭ j u t ɨ ɭ
융융	j u ŋ j u ŋ
으그르르	ɨ k ɨ ɭ ɨ ɭ ɨ
으드득	ɨ t ɨ t ɨ k
으드득으드득	ɨ t ɨ t ɨ k ɨ t ɨ t ɨ k
으드등으드등	ɨ t ɨ t ɨ ŋ ɨ t ɨ t ɨ ŋ
으등부등	ɨ t ɨ ŋ p u t ɨ ŋ
으등으등	ɨ t ɨ ŋ ɨ t ɨ ŋ
으르렁	ɨ ɭ ɨ ɭ ʌ ŋ
으르렁으르렁	ɨ ɭ ɨ ɭ ʌ ŋ ɨ ɭ ɨ ɭ ʌ ŋ
으르르	ɨ ɭ ɨ ɭ ɨ
으밀아밀	ɨ m i ɭ ɐ m i ɭ
으스스	ɨ s ɨ s ɨ
으슬으슬	ɨ s ɨ ɭ ɨ s ɨ ɭ
으슴푸레	ɨ s ɨ m pʰ u ɭ e
으썩	ɨ s͈ ʌ k
으썩으썩	ɨ s͈ ʌ k ɨ s͈ ʌ k
으쓱	ɨ s͈ ɨ k
으쓱으쓱	ɨ s͈ ɨ k ɨ s͈ ɨ k
으아	ɨ ɐ
으악	ɨ ɐ k
으앙	ɨ ɐ ŋ
으앙으앙	ɨ ɐ ŋ ɨ ɐ ŋ
으적	ɨ tɕ ʌ k
으적으적	ɨ tɕ ʌ k ɨ tɕ ʌ k
으지직	ɨ tɕ i tɕ i k
으지직으지직	ɨ tɕ i tɕ i k ɨ tɕ i tɕ i k
으쩍	ɨ tɕ͈ ʌ k
으쩍으쩍	ɨ tɕ͈ ʌ k ɨ tɕ͈ ʌ k
으하하	ɨ ɐ h ɐ
으허허	ɨ ʌ h ʌ
으흐흐	ɨ ɨ h ɨ
으흐흑	ɨ ɨ h ɨ k
을근을근	ɨ ɭ k ɨ n ɨ ɭ k ɨ n
을밋을밋	ɨ ɭ m i s ɨ ɭ m i t
응아	ɨ ŋ ɐ
응아응아	ɨ ŋ ɐ ɨ ŋ ɐ
응애	ɨ ŋ ɛ
응애응애	ɨ ŋ ɛ ɨ ŋ ɛ
응얼응얼	ɨ ŋ ʌ ɭ ɨ ŋ ʌ ɭ
응응	ɨ ŋ ɨ ŋ
이드거니	i t ɨ k ʌ n i
이드르르	i t ɨ ɭ ɨ ɭ ɨ
이러구러	i ɭ ʌ k u ɭ ʌ
이러쿵저러쿵	i ɭ ʌ kʰ u ŋ tɕ ʌ ɭ ʌ kʰ u ŋ
이리	i ɭ i
이리저리	i ɭ i tɕ ʌ ɭ i
이리쿵저리쿵	i ɭ i kʰ u ŋ tɕ ʌ ɭ i kʰ u ŋ
이죽삐죽	i tɕ u k p͈ i tɕ u k
이죽야죽	i tɕ u k j ɐ tɕ u k
이히히	i i h i
인성만성	i n s ʌ ŋ m ɐ n s ʌ ŋ
일긋얄긋	i ɭ k ɨ s j ɐ ɭ k ɨ t
일긋일긋	i ɭ k ɨ s i ɭ k ɨ t
일기죽얄기죽	i ɭ k i tɕ u k j ɐ ɭ k i tɕ u k
일기죽일기죽	i ɭ k i tɕ u k i ɭ k i tɕ u k
일렁얄랑	i ɭ ɭ ʌ ŋ j ɐ ɭ ɭ ɐ ŋ
일렁일렁	i ɭ ɭ ʌ ŋ i ɭ ɭ ʌ ŋ
일쭉얄쭉	i ɭ tɕ͈ u k j ɐ ɭ tɕ͈ u k
일쭉일쭉	i ɭ tɕ͈ u k i ɭ tɕ͈ u k
잉	i ŋ
잉잉	i ŋ i ŋ
자그락자그락	tɕ ɐ k ɨ ɭ ɐ k tɕ͈ ɐ k ɨ ɭ ɐ k
자그르르	tɕ ɐ k ɨ ɭ ɨ ɭ ɨ
자그시	tɕ ɐ k ɨ s i
자근덕자근덕	tɕ ɐ k ɨ n t ʌ k tɕ͈ ɐ k ɨ n t ʌ k
자근자근	tɕ ɐ k ɨ n tɕ ɐ k ɨ n
자글자글	tɕ ɐ k ɨ ɭ tɕ ɐ k ɨ ɭ
자금자금	tɕ ɐ k ɨ m tɕ ɐ k ɨ m
자긋자긋	tɕ ɐ k ɨ t tɕ͈ ɐ k ɨ t
자끈	tɕ ɐ k͈ ɨ n
자끈동	tɕ ɐ k͈ ɨ n t o ŋ
자끈자끈	tɕ ɐ k͈ ɨ n tɕ ɐ k͈ ɨ n
자끔자끔	tɕ ɐ k͈ ɨ m tɕ ɐ k͈ ɨ m
자늑자늑	tɕ ɐ n ɨ k tɕ͈ ɐ n ɨ k
자드락자드락	tɕ ɐ t ɨ ɭ ɐ k tɕ͈ ɐ t ɨ ɭ ɐ k
자락자락	tɕ ɐ ɭ ɐ k tɕ͈ ɐ ɭ ɐ k
자란자란	tɕ ɐ ɭ ɐ n tɕ ɐ ɭ ɐ n
자랑	tɕ ɐ ɭ ɐ ŋ
자랑자랑	tɕ ɐ ɭ ɐ ŋ tɕ ɐ ɭ ɐ ŋ
자르랑	tɕ ɐ ɭ ɨ ɭ ɐ ŋ
자르랑자르랑	tɕ ɐ ɭ ɨ ɭ ɐ ŋ tɕ ɐ ɭ ɨ ɭ ɐ ŋ
자르르	tɕ ɐ ɭ ɨ ɭ ɨ
자리자리	tɕ ɐ ɭ i tɕ ɐ ɭ i
자릿자릿	tɕ ɐ ɭ i t tɕ͈ ɐ ɭ i t
자박	tɕ ɐ p ɐ k
자박자박	tɕ ɐ p ɐ k tɕ͈ ɐ p ɐ k
자밤자밤	tɕ ɐ p ɐ m tɕ ɐ p ɐ m
자부락자부락	tɕ ɐ p u ɭ ɐ k tɕ͈ ɐ p u ɭ ɐ k
자분닥자분닥	tɕ ɐ p u n t ɐ k tɕ͈ ɐ p u n t ɐ k
자분자분	tɕ ɐ p u n tɕ ɐ p u n
자작자작	tɕ ɐ tɕ ɐ k tɕ͈ ɐ tɕ ɐ k
자질자질	tɕ ɐ tɕ i ɭ tɕ ɐ tɕ i ɭ
자축자축	tɕ ɐ tɕʰ u k tɕ͈ ɐ tɕʰ u k
자춤자춤	tɕ ɐ tɕʰ u m tɕ ɐ tɕʰ u m
자칫자칫	tɕ ɐ tɕʰ i t tɕ͈ ɐ tɕʰ i t
작	tɕ ɐ k
작신	tɕ ɐ k s͈ i n
작신작신	tɕ ɐ k s͈ i n tɕ ɐ k s͈ i n
작작	tɕ ɐ k tɕ͈ ɐ k
잔득잔득	tɕ ɐ n t ɨ k tɕ͈ ɐ n t ɨ k
잔물잔물	tɕ ɐ n m u ɭ tɕ ɐ n m u ɭ
잘가닥	tɕ ɐ ɭ k ɐ t ɐ k
잘가닥잘가닥	tɕ ɐ ɭ k ɐ t ɐ k tɕ͈ ɐ ɭ k ɐ t ɐ k
잘가당	tɕ ɐ ɭ k ɐ t ɐ ŋ
잘가당잘가당	tɕ ɐ ɭ k ɐ t ɐ ŋ tɕ ɐ ɭ k ɐ t ɐ ŋ
잘강잘강	tɕ ɐ ɭ k ɐ ŋ tɕ ɐ ɭ k ɐ ŋ
잘그락	tɕ ɐ ɭ k ɨ ɭ ɐ k
잘그락잘그락	tɕ ɐ ɭ k ɨ ɭ ɐ k tɕ͈ ɐ ɭ k ɨ ɭ ɐ k
잘그랑	tɕ ɐ ɭ k ɨ ɭ ɐ ŋ
잘그랑잘그랑	tɕ ɐ ɭ k ɨ ɭ ɐ ŋ tɕ ɐ ɭ k ɨ ɭ ɐ ŋ
잘근	tɕ ɐ ɭ k ɨ n
잘근잘근	tɕ ɐ ɭ k ɨ n tɕ ɐ ɭ k ɨ n
잘금	tɕ ɐ ɭ k ɨ m
잘금잘금	tɕ ɐ ɭ k ɨ m tɕ ɐ ɭ k ɨ m
잘기잘기	tɕ ɐ ɭ k i tɕ ɐ ɭ k i
잘깃잘깃	tɕ ɐ ɭ k i t tɕ͈ ɐ ɭ k i t
잘까닥	tɕ ɐ ɭ k͈ ɐ t ɐ k
잘까닥잘까닥	tɕ ɐ ɭ k͈ ɐ t ɐ k tɕ͈ ɐ ɭ k͈ ɐ t ɐ k
잘까당	tɕ ɐ ɭ k͈ ɐ t ɐ ŋ
잘까당잘까당	tɕ ɐ ɭ k͈ ɐ t ɐ ŋ tɕ ɐ ɭ k͈ ɐ t ɐ ŋ
잘끈	tɕ ɐ ɭ k͈ ɨ n
잘끈잘끈	tɕ ɐ ɭ k͈ ɨ n tɕ ɐ ɭ k͈ ɨ n
잘똑잘똑	tɕ ɐ ɭ t͈ o k tɕ͈ ɐ ɭ t͈ o k
잘랑	tɕ ɐ ɭ ɭ ɐ ŋ
잘랑잘랑	tɕ ɐ ɭ ɭ ɐ ŋ tɕ ɐ ɭ ɭ ɐ ŋ
잘래잘래	tɕ ɐ ɭ ɭ ɛ tɕ ɐ ɭ ɭ ɛ
잘록	tɕ ɐ ɭ ɭ o k
잘록잘록	tɕ ɐ ɭ ɭ o k tɕ͈ ɐ ɭ ɭ o k
잘름잘름	tɕ ɐ ɭ ɭ ɨ m tɕ ɐ ɭ ɭ ɨ m
잘바닥	tɕ ɐ ɭ p ɐ t ɐ k
잘바닥잘바닥	tɕ ɐ ɭ p ɐ t ɐ k tɕ͈ ɐ ɭ p ɐ t ɐ k
잘바당	tɕ ɐ ɭ p ɐ t ɐ ŋ
잘바당잘바당	tɕ ɐ ɭ p ɐ t ɐ ŋ tɕ ɐ ɭ p ɐ t ɐ ŋ
잘싸닥	tɕ ɐ ɭ s͈ ɐ t ɐ k
잘싸닥잘싸닥	tɕ ɐ ɭ s͈ ɐ t ɐ k tɕ͈ ɐ ɭ s͈ ɐ t ɐ k
잘쏙잘쏙	tɕ ɐ ɭ s͈ o k tɕ͈ ɐ ɭ s͈ o k
잘잘	tɕ ɐ ɭ tɕ ɐ ɭ
잘착잘착	tɕ ɐ ɭ tɕʰ ɐ k tɕ͈ ɐ ɭ tɕʰ ɐ k
잘카닥	tɕ ɐ ɭ kʰ ɐ t ɐ k
잘카닥잘카닥	tɕ ɐ ɭ kʰ ɐ t ɐ k tɕ͈ ɐ ɭ kʰ ɐ t ɐ k
잘카당	tɕ ɐ ɭ kʰ ɐ t ɐ ŋ
잘카당잘카당	tɕ ɐ ɭ kʰ ɐ t ɐ ŋ tɕ ɐ ɭ kʰ ɐ t ɐ ŋ
잘파닥	tɕ ɐ ɭ pʰ ɐ t ɐ k
잘파닥잘파닥	tɕ ɐ ɭ pʰ ɐ t ɐ k tɕ͈ ɐ ɭ pʰ ɐ t ɐ k
잠깐잠깐	tɕ ɐ m k͈ ɐ n tɕ ɐ m k͈ ɐ n
잠방	tɕ ɐ m p ɐ ŋ
잠방잠방	tɕ ɐ m p ɐ ŋ tɕ ɐ m p ɐ ŋ
장알장알	tɕ ɐ ŋ ɐ ɭ tɕ ɐ ŋ ɐ ɭ
재갈재갈	tɕ ɛ k ɐ ɭ tɕ ɛ k ɐ ɭ
재그르르	tɕ ɛ k ɨ ɭ ɨ ɭ ɨ
재그시	tɕ ɛ k ɨ s i
재까닥	tɕ ɛ k͈ ɐ t ɐ k
재까닥재까닥	tɕ ɛ k͈ ɐ t ɐ k tɕ͈ ɛ k͈ ɐ t ɐ k
재깍	tɕ ɛ k͈ ɐ k
재깍재깍	tɕ ɛ k͈ ɐ k tɕ͈ ɛ k͈ ɐ k
재깔재깔	tɕ ɛ k͈ ɐ ɭ tɕ ɛ k͈ ɐ ɭ
재자재자	tɕ ɛ tɕ ɐ tɕ ɛ tɕ ɐ
재잘재잘	tɕ ɛ tɕ ɐ ɭ tɕ ɛ tɕ ɐ ɭ
재재	tɕ ɛ tɕ ɛ
재재재재	tɕ ɛ tɕ ɛ tɕ ɛ tɕ ɛ
잴잴	tɕ ɛ ɭ tɕ ɛ ɭ
쟁강	tɕ ɛ ŋ k ɐ ŋ
쟁강쟁강	tɕ ɛ ŋ k ɐ ŋ tɕ ɛ ŋ k ɐ ŋ
쟁그랑	tɕ ɛ ŋ k ɨ ɭ ɐ ŋ
쟁그랑쟁그랑	tɕ ɛ ŋ k ɨ ɭ ɐ ŋ tɕ ɛ ŋ k ɨ ɭ ɐ ŋ
쟁글쟁글	tɕ ɛ ŋ k ɨ ɭ tɕ ɛ ŋ k ɨ ɭ
쟁쟁	tɕ ɛ ŋ tɕ ɛ ŋ
저렁	tɕ ʌ ɭ ʌ ŋ
저렁저렁	tɕ ʌ ɭ ʌ ŋ tɕ ʌ ɭ ʌ ŋ
저르렁	tɕ ʌ ɭ ɨ ɭ ʌ ŋ
저르렁저르렁	tɕ ʌ ɭ ɨ ɭ ʌ ŋ tɕ ʌ ɭ ɨ ɭ ʌ ŋ
저리	tɕ ʌ ɭ i
저리저리	tɕ ʌ ɭ i tɕ ʌ ɭ i
저릿저릿	tɕ ʌ ɭ i t tɕ͈ ʌ ɭ i t
저벅	tɕ ʌ p ʌ k
저벅저벅	tɕ ʌ p ʌ k tɕ͈ ʌ p ʌ k
저분저분	tɕ ʌ p u n tɕ ʌ p u n
저적저적	tɕ ʌ tɕ ʌ k tɕ͈ ʌ tɕ ʌ k
저축저축	tɕ ʌ tɕʰ u k tɕ͈ ʌ tɕʰ u k
저춤저춤	tɕ ʌ tɕʰ u m tɕ ʌ tɕʰ u m
절거덕	tɕ ʌ ɭ k ʌ t ʌ k
절거덕절거덕	tɕ ʌ ɭ k ʌ t ʌ k tɕ͈ ʌ ɭ k ʌ t ʌ k
절거덩	tɕ ʌ ɭ k ʌ t ʌ ŋ
절거덩절거덩	tɕ ʌ ɭ k ʌ t ʌ ŋ tɕ ʌ ɭ k ʌ t ʌ ŋ
절그럭	tɕ ʌ ɭ k ɨ ɭ ʌ k
절그럭절그럭	tɕ ʌ ɭ k ɨ ɭ ʌ k tɕ͈ ʌ ɭ k ɨ ɭ ʌ k
절그렁	tɕ ʌ ɭ k ɨ ɭ ʌ ŋ
절그렁절그렁	tɕ ʌ ɭ k ɨ ɭ ʌ ŋ tɕ ʌ ɭ k ɨ ɭ ʌ ŋ
절꺼덕	tɕ ʌ ɭ k͈ ʌ t ʌ k
절꺼덕절꺼덕	tɕ ʌ ɭ k͈ ʌ t ʌ k tɕ͈ ʌ ɭ k͈ ʌ t ʌ k
절꺼덩	tɕ ʌ ɭ k͈ ʌ t ʌ ŋ
절꺼덩절꺼덩	tɕ ʌ ɭ k͈ ʌ t ʌ ŋ tɕ ʌ ɭ k͈ ʌ t ʌ ŋ
절뚝절뚝	tɕ ʌ ɭ t͈ u k tɕ͈ ʌ ɭ t͈ u k
절렁	tɕ ʌ ɭ ɭ ʌ ŋ
절렁절렁	tɕ ʌ ɭ ɭ ʌ ŋ tɕ ʌ ɭ ɭ ʌ ŋ
절레절레	tɕ ʌ ɭ ɭ e tɕ ʌ ɭ ɭ e
절룩절룩	tɕ ʌ ɭ ɭ u k tɕ͈ ʌ ɭ ɭ u k
절름절름	tɕ ʌ ɭ ɭ ɨ m tɕ ʌ ɭ ɭ ɨ m
절버덕	tɕ ʌ ɭ p ʌ t ʌ k
절버덕절버덕	tɕ ʌ ɭ p ʌ t ʌ k tɕ͈ ʌ ɭ p ʌ t ʌ k
절버덩	tɕ ʌ ɭ p ʌ t ʌ ŋ
절버덩절버덩	tɕ ʌ ɭ p ʌ t ʌ ŋ tɕ ʌ ɭ p ʌ t ʌ ŋ
절써덕	tɕ ʌ ɭ s͈ ʌ t ʌ k
절써덕절써덕	tɕ ʌ ɭ s͈ ʌ t ʌ k tɕ͈ ʌ ɭ s͈ ʌ t ʌ k
절쑥절쑥	tɕ ʌ ɭ s͈ u k tɕ͈ ʌ ɭ s͈ u k
절절	tɕ ʌ ɭ tɕ ʌ ɭ
절커덕	tɕ ʌ ɭ kʰ ʌ t ʌ k
절커덕절커덕	tɕ ʌ ɭ kʰ ʌ t ʌ k tɕ͈ ʌ ɭ kʰ ʌ t ʌ k
절커덩	tɕ ʌ ɭ kʰ ʌ t ʌ ŋ
절커덩절커덩	tɕ ʌ ɭ kʰ ʌ t ʌ ŋ tɕ ʌ ɭ kʰ ʌ t ʌ ŋ
절퍼덕	tɕ ʌ ɭ pʰ ʌ t ʌ k
절퍼덕절퍼덕	tɕ ʌ ɭ pʰ ʌ t ʌ k tɕ͈ ʌ ɭ pʰ ʌ t ʌ k
점벙	tɕ ʌ m p ʌ ŋ
점벙점벙	tɕ ʌ m p ʌ ŋ tɕ ʌ m p ʌ ŋ
접첨접첨	tɕ ʌ p tɕʰ ʌ m tɕ ʌ p tɕʰ ʌ m
접침접침	tɕ ʌ p tɕʰ i m tɕ ʌ p tɕʰ i m
정	tɕ ʌ ŋ
제걱제걱	tɕ e k ʌ k tɕ͈ e k ʌ k
제꺼덕	tɕ e k͈ ʌ t ʌ k
제꺼덕제꺼덕	tɕ e k͈ ʌ t ʌ k tɕ͈ e k͈ ʌ t ʌ k
제꺽	tɕ e k͈ ʌ k
제꺽제꺽	tɕ e k͈ ʌ k tɕ͈ e k͈ ʌ k
젱겅	tɕ e ŋ k ʌ ŋ
젱겅젱겅	tɕ e ŋ k ʌ ŋ tɕ e ŋ k ʌ ŋ
젱그렁	tɕ e ŋ k ɨ ɭ ʌ ŋ
젱그렁젱그렁	tɕ e ŋ k ɨ ɭ ʌ ŋ tɕ e ŋ k ɨ ɭ ʌ ŋ
조곤조곤	tɕ o k o n tɕ o k o n
조글조글	tɕ o k ɨ ɭ tɕ o k ɨ ɭ
조금조금	tɕ o k ɨ m tɕ o k ɨ m
조끔조끔	tɕ o k͈ ɨ m tɕ o k͈ ɨ m
조랑조랑	tɕ o ɭ ɐ ŋ tɕ o ɭ ɐ ŋ
조록	tɕ o ɭ o k
조록조록	tɕ o ɭ o k tɕ͈ o ɭ o k
조롱조롱	tɕ o ɭ o ŋ tɕ o ɭ o ŋ
조르르	tɕ o ɭ ɨ ɭ ɨ
조르륵	tɕ o ɭ ɨ ɭ ɨ k
조르륵조르륵	tɕ o ɭ ɨ ɭ ɨ k tɕ͈ o ɭ ɨ ɭ ɨ k
조리	tɕ o ɭ i
조릿조릿	tɕ o ɭ i t tɕ͈ o ɭ i t
조마조마	tɕ o m ɐ tɕ o m ɐ
조몰락조몰락	tɕ o m o ɭ ɭ ɐ k tɕ͈ o m o ɭ ɭ ɐ k
조물조물	tɕ o m u ɭ tɕ o m u ɭ
조뼛	tɕ o p͈ j ʌ t
조뼛조뼛	tɕ o p͈ j ʌ t tɕ͈ o p͈ j ʌ t
조속조속	tɕ o s o k tɕ͈ o s o k
조용조용	tɕ o j o ŋ tɕ o j o ŋ
조작조작	tɕ o tɕ ɐ k tɕ͈ o tɕ ɐ k
조잔조잔	tɕ o tɕ ɐ n tɕ o tɕ ɐ n
조잘조잘	tɕ o tɕ ɐ ɭ tɕ o tɕ ɐ ɭ
조촘	tɕ o tɕʰ o m
조촘조촘	tɕ o tɕʰ o m tɕ o tɕʰ o m
족	tɕ o k
족족	tɕ o k tɕ͈ o k
존득존득	tɕ o n t ɨ k tɕ͈ o n t ɨ k
졸금	tɕ o ɭ k ɨ m
졸금졸금	tɕ o ɭ k ɨ m tɕ o ɭ k ɨ m
졸깃졸깃	tɕ o ɭ k i t tɕ͈ o ɭ k i t
졸딱졸딱	tɕ o ɭ t͈ ɐ k tɕ͈ o ɭ t͈ ɐ k
졸랑졸랑	tɕ o ɭ ɭ ɐ ŋ tɕ o ɭ ɭ ɐ ŋ
졸래졸래	tɕ o ɭ ɭ ɛ tɕ o ɭ ɭ ɛ
졸막졸막	tɕ o ɭ m ɐ k tɕ͈ o ɭ m ɐ k
졸망졸망	tɕ o ɭ m ɐ ŋ tɕ o ɭ m ɐ ŋ
졸졸	tɕ o ɭ tɕ o ɭ
종달종달	tɕ o ŋ t ɐ ɭ tɕ o ŋ t ɐ ɭ
종알종알	tɕ o ŋ ɐ ɭ tɕ o ŋ ɐ ɭ
종잘종잘	tɕ o ŋ tɕ ɐ ɭ tɕ o ŋ tɕ ɐ ɭ
종종	tɕ o ŋ tɕ o ŋ
좌르르	tɕ w ɐ ɭ ɨ ɭ ɨ
좌르륵	tɕ w ɐ ɭ ɨ ɭ ɨ k
좌르륵좌르륵	tɕ w ɐ ɭ ɨ ɭ ɨ k tɕ͈ w ɐ ɭ ɨ ɭ ɨ k
좍	tɕ w ɐ k
좍좍	tɕ w ɐ k tɕ͈ w ɐ k
좔좔	tɕ w ɐ ɭ tɕ w ɐ ɭ
주근주근	tɕ u k ɨ n tɕ u k ɨ n
주글주글	tɕ u k ɨ ɭ tɕ u k ɨ ɭ
주렁주렁	tɕ u ɭ ʌ ŋ tɕ u ɭ ʌ ŋ
주룩	tɕ u ɭ u k
주룩주룩	tɕ u ɭ u k tɕ͈ u ɭ u k
주르르	tɕ u ɭ ɨ ɭ ɨ
주르륵	tɕ u ɭ ɨ ɭ ɨ k
주르륵주르륵	tɕ u ɭ ɨ ɭ ɨ k tɕ͈ u ɭ ɨ ɭ ɨ k
주물럭주물럭	tɕ u m u ɭ ɭ ʌ k tɕ͈ u m u ɭ ɭ ʌ k
주뼛	tɕ u p͈ j ʌ t
주뼛주뼛	tɕ u p͈ j ʌ t tɕ͈ u p͈ j ʌ t
주섬주섬	tɕ u s ʌ m tɕ u s ʌ m
주억	tɕ u ʌ k
주억주억	tɕ u ʌ k tɕ͈ u ʌ k
주저리주저리	tɕ u tɕ ʌ ɭ i tɕ u tɕ ʌ ɭ i
주적주적	tɕ u tɕ ʌ k tɕ͈ u tɕ ʌ k
주전주전	tɕ u tɕ ʌ n tɕ u tɕ ʌ n
주절주절	tɕ u tɕ ʌ ɭ tɕ u tɕ ʌ ɭ
주춤	tɕ u tɕʰ u m
주춤주춤	tɕ u tɕʰ u m tɕ u tɕʰ u m
죽	tɕ u k
죽죽	tɕ u k tɕ͈ u k
준득준득	tɕ u n t ɨ k tɕ͈ u n t ɨ k
줄깃줄깃	tɕ u ɭ k i t tɕ͈ u ɭ k i t
줄렁줄렁	tɕ u ɭ ɭ ʌ ŋ tɕ u ɭ ɭ ʌ ŋ
줄레줄레	tɕ u ɭ ɭ e tɕ u ɭ ɭ e
줄룩줄룩	tɕ u ɭ ɭ u k tɕ͈ u ɭ ɭ u k
줄먹줄먹	tɕ u ɭ m ʌ k tɕ͈ u ɭ m ʌ k
줄멍줄멍	tɕ u ɭ m ʌ ŋ tɕ u ɭ m ʌ ŋ
줄줄	tɕ u ɭ tɕ u ɭ
중기중기	tɕ u ŋ k i tɕ u ŋ k i
중덜중덜	tɕ u ŋ t ʌ ɭ tɕ u ŋ t ʌ ɭ
중얼중얼	tɕ u ŋ ʌ ɭ tɕ u ŋ ʌ ɭ
중절중절	tɕ u ŋ tɕ ʌ ɭ tɕ u ŋ tɕ ʌ ɭ
쥐락펴락	tɕ w i ɭ ɐ k pʰ j ʌ ɭ ɐ k
즈런즈런	tɕ ɨ ɭ ʌ n tɕ ɨ ɭ ʌ n
지국총	tɕ i k u k tɕʰ o ŋ
지국총지국총	tɕ i k u k tɕʰ o ŋ tɕ i k u k tɕʰ o ŋ
지그럭지그럭	tɕ i k ɨ ɭ ʌ k tɕ͈ i k ɨ ɭ ʌ k
지그르르	tɕ i k ɨ ɭ ɨ ɭ ɨ
지그시	tɕ i k ɨ s i
지근덕지근덕	tɕ i k ɨ n t ʌ k tɕ͈ i k ɨ n t ʌ k
지근지근	tɕ i k ɨ n tɕ i k ɨ n
지글지글	tɕ i k ɨ ɭ tɕ i k ɨ ɭ
지금지금	tɕ i k ɨ m tɕ i k ɨ m
지긋지긋	tɕ i k ɨ t tɕ͈ i k ɨ t
지껄지껄	tɕ i k͈ ʌ ɭ tɕ i k͈ ʌ ɭ
지끈	tɕ i k͈ ɨ n
지끈둥	tɕ i k͈ ɨ n t u ŋ
지끈지끈	tɕ i k͈ ɨ n tɕ i k͈ ɨ n
지끔지끔	tɕ i k͈ ɨ m tɕ i k͈ ɨ m
지드럭지드럭	tɕ i t ɨ ɭ ʌ k tɕ͈ i t ɨ ɭ ʌ k
지딱지딱	tɕ i t͈ ɐ k tɕ͈ i t͈ ɐ k
지런지런	tɕ i ɭ ʌ n tɕ i ɭ ʌ n
지르르	tɕ i ɭ ɨ ɭ ɨ
지망지망	tɕ i m ɐ ŋ tɕ i m ɐ ŋ
지며리	tɕ i m j ʌ ɭ i
지벅지벅	tɕ i p ʌ k tɕ͈ i p ʌ k
지범지범	tɕ i p ʌ m tɕ i p ʌ m
지부럭지부럭	tɕ i p u ɭ ʌ k tɕ͈ i p u ɭ ʌ k
지분덕지분덕	tɕ i p u n t ʌ k tɕ͈ i p u n t ʌ k
지분지분	tɕ i p u n tɕ i p u n
지뻑지뻑	tɕ i p͈ ʌ k tɕ͈ i p͈ ʌ k
지싯지싯	tɕ i s i t tɕ͈ i s i t
지저지저	tɕ i tɕ ʌ tɕ i tɕ ʌ
지적지적	tɕ i tɕ ʌ k tɕ͈ i tɕ ʌ k
지절지절	tɕ i tɕ ʌ ɭ tɕ i tɕ ʌ ɭ
지정지정	tɕ i tɕ ʌ ŋ tɕ i tɕ ʌ ŋ
지지	tɕ i tɕ i
지지배배	tɕ i tɕ i p ɛ p ɛ
지지재재	tɕ i tɕ i tɕ ɛ tɕ ɛ
지지지지	tɕ i tɕ i tɕ i tɕ i
지질지질	tɕ i tɕ i ɭ tɕ i tɕ i ɭ
지짐지짐	tɕ i tɕ i m tɕ i tɕ i m
지척지척	tɕ i tɕʰ ʌ k tɕ͈ i tɕʰ ʌ k
지칫지칫	tɕ i tɕʰ i t tɕ͈ i tɕʰ i t
직	tɕ i k
직신직신	tɕ i k s͈ i n tɕ i k s͈ i n
직직	tɕ i k tɕ͈ i k
진동한동	tɕ i n t o ŋ h ɐ n t o ŋ
진둥한둥	tɕ i n t u ŋ h ɐ n t u ŋ
진득진득	tɕ i n t ɨ k tɕ͈ i n t ɨ k
진물진물	tɕ i n m u ɭ tɕ i n m u ɭ
질겅질겅	tɕ i ɭ k ʌ ŋ tɕ i ɭ k ʌ ŋ
질근	tɕ i ɭ k ɨ n
질근질근	tɕ i ɭ k ɨ n tɕ i ɭ k ɨ n
질금	tɕ i ɭ k ɨ m
질금질금	tɕ i ɭ k ɨ m tɕ i ɭ k ɨ m
질긋질긋	tɕ i ɭ k ɨ t tɕ͈ i ɭ k ɨ t
질깃질깃	tɕ i ɭ k i t tɕ͈ i ɭ k i t
질끈	tɕ i ɭ k͈ ɨ n
질끈질끈	tɕ i ɭ k͈ ɨ n tɕ i ɭ k͈ ɨ n
질뚝질뚝	tɕ i ɭ t͈ u k tɕ͈ i ɭ t͈ u k
질룩	tɕ i ɭ ɭ u k
질룩질룩	tɕ i ɭ ɭ u k tɕ͈ i ɭ ɭ u k
질름질름	tɕ i ɭ ɭ ɨ m tɕ i ɭ ɭ ɨ m
질버덕질버덕	tɕ i ɭ p ʌ t ʌ k tɕ͈ i ɭ p ʌ t ʌ k
질쑥질쑥	tɕ i ɭ s͈ u k tɕ͈ i ɭ s͈ u k
질질	tɕ i ɭ tɕ i ɭ
질척질척	tɕ i ɭ tɕʰ ʌ k tɕ͈ i ɭ tɕʰ ʌ k
질커덕질커덕	tɕ i ɭ kʰ ʌ t ʌ k tɕ͈ i ɭ kʰ ʌ t ʌ k
질퍼덕질퍼덕	tɕ i ɭ pʰ ʌ t ʌ k tɕ͈ i ɭ pʰ ʌ t ʌ k
집적집적	tɕ i p tɕ͈ ʌ k tɕ͈ i p tɕ͈ ʌ k
징	tɕ i ŋ
징검징검	tɕ i ŋ k ʌ m tɕ i ŋ k ʌ m
징그러이	tɕ i ŋ k ɨ ɭ ʌ i
징글징글	tɕ i ŋ k ɨ ɭ tɕ i ŋ k ɨ ɭ
징얼징얼	tɕ i ŋ ʌ ɭ tɕ i ŋ ʌ ɭ
징징	tɕ i ŋ tɕ i ŋ
짜그락짜그락	tɕ͈ ɐ k ɨ ɭ ɐ k tɕ͈ ɐ k ɨ ɭ ɐ k
짜그르르	tɕ͈ ɐ k ɨ ɭ ɨ ɭ ɨ
짜근덕짜근덕	tɕ͈ ɐ k ɨ n t ʌ k tɕ͈ ɐ k ɨ n t ʌ k
짜근짜근	tɕ͈ ɐ k ɨ n tɕ͈ ɐ k ɨ n
짜글짜글	tɕ͈ ɐ k ɨ ɭ tɕ͈ ɐ k ɨ ɭ
짜금짜금	tɕ͈ ɐ k ɨ m tɕ͈ ɐ k ɨ m
짜긋	tɕ͈ ɐ k ɨ t
짜긋짜긋	tɕ͈ ɐ k ɨ t tɕ͈ ɐ k ɨ t
짜드락짜드락	tɕ͈ ɐ t ɨ ɭ ɐ k tɕ͈ ɐ t ɨ ɭ ɐ k
짜득짜득	tɕ͈ ɐ t ɨ k tɕ͈ ɐ t ɨ k
짜들름짜들름	tɕ͈ ɐ t ɨ ɭ ɭ ɨ m tɕ͈ ɐ t ɨ ɭ ɭ ɨ m
짜뜰름짜뜰름	tɕ͈ ɐ t͈ ɨ ɭ ɭ ɨ m tɕ͈ ɐ t͈ ɨ ɭ ɭ ɨ m
짜락	tɕ͈ ɐ ɭ ɐ k
짜락짜락	tɕ͈ ɐ ɭ ɐ k tɕ͈ ɐ ɭ ɐ k
짜랑	tɕ͈ ɐ ɭ ɐ ŋ
짜랑짜랑	tɕ͈ ɐ ɭ ɐ ŋ tɕ͈ ɐ ɭ ɐ ŋ
짜르랑	tɕ͈ ɐ ɭ ɨ ɭ ɐ ŋ
짜르랑짜르랑	tɕ͈ ɐ ɭ ɨ ɭ ɐ ŋ tɕ͈ ɐ ɭ ɨ ɭ ɐ ŋ
짜르르	tɕ͈ ɐ ɭ ɨ ɭ ɨ
짜르륵	tɕ͈ ɐ ɭ ɨ ɭ ɨ k
짜르륵짜르륵	tɕ͈ ɐ ɭ ɨ ɭ ɨ k tɕ͈ ɐ ɭ ɨ ɭ ɨ k
짜릿짜릿	tɕ͈ ɐ ɭ i t tɕ͈ ɐ ɭ i t
짜박	tɕ͈ ɐ p ɐ k
짜박짜박	tɕ͈ ɐ p ɐ k tɕ͈ ɐ p ɐ k
짝	tɕ͈ ɐ k
짝자그르	tɕ͈ ɐ k tɕ͈ ɐ k ɨ ɭ ɨ
짝짝	tɕ͈ ɐ k tɕ͈ ɐ k
짠득짠득	tɕ͈ ɐ n t ɨ k tɕ͈ ɐ n t ɨ k
짤가닥	tɕ͈ ɐ ɭ k ɐ t ɐ k
짤가닥짤가닥	tɕ͈ ɐ ɭ k ɐ t ɐ k tɕ͈ ɐ ɭ k ɐ t ɐ k
짤가당	tɕ͈ ɐ ɭ k ɐ t ɐ ŋ
짤가당짤가당	tɕ͈ ɐ ɭ k ɐ t ɐ ŋ tɕ͈ ɐ ɭ k ɐ t ɐ ŋ
짤그락	tɕ͈ ɐ ɭ k ɨ ɭ ɐ k
짤그락짤그락	tɕ͈ ɐ ɭ k ɨ ɭ ɐ k tɕ͈ ɐ ɭ k ɨ ɭ ɐ k
짤그랑	tɕ͈ ɐ ɭ k ɨ ɭ ɐ ŋ
짤그랑짤그랑	tɕ͈ ɐ ɭ k ɨ ɭ ɐ ŋ tɕ͈ ɐ ɭ k ɨ ɭ ɐ ŋ
짤깃짤깃	tɕ͈ ɐ ɭ k i t tɕ͈ ɐ ɭ k i t
짤까닥	tɕ͈ ɐ ɭ k͈ ɐ t ɐ k
짤까닥짤까닥	tɕ͈ ɐ ɭ k͈ ɐ t ɐ k tɕ͈ ɐ ɭ k͈ ɐ t ɐ k
짤까당	tɕ͈ ɐ ɭ k͈ ɐ t ɐ ŋ
짤까당짤까당	tɕ͈ ɐ ɭ k͈ ɐ t ɐ ŋ tɕ͈ ɐ ɭ k͈ ɐ t ɐ ŋ
짤끔	tɕ͈ ɐ ɭ k͈ ɨ m
짤끔짤끔	tɕ͈ ɐ ɭ k͈ ɨ m tɕ͈ ɐ ɭ k͈ ɨ m
짤똑짤똑	tɕ͈ ɐ ɭ t͈ o k tɕ͈ ɐ ɭ t͈ o k
짤랑	tɕ͈ ɐ ɭ ɭ ɐ ŋ
짤랑짤랑	tɕ͈ ɐ ɭ ɭ ɐ ŋ tɕ͈ ɐ ɭ ɭ ɐ ŋ
짤래짤래	tɕ͈ ɐ ɭ ɭ ɛ tɕ͈ ɐ ɭ ɭ ɛ
짤록	tɕ͈ ɐ ɭ ɭ o k
짤록짤록	tɕ͈ ɐ ɭ ɭ o k tɕ͈ ɐ ɭ ɭ o k
짤름짤름	tɕ͈ ɐ ɭ ɭ ɨ m tɕ͈ ɐ ɭ ɭ ɨ m
짤막짤막	tɕ͈ ɐ ɭ m ɐ k tɕ͈ ɐ ɭ m ɐ k
짤쏙짤쏙	tɕ͈ ɐ ɭ s͈ o k tɕ͈ ɐ ɭ s͈ o k
짤짤	tɕ͈ ɐ ɭ tɕ͈ ɐ ɭ
짤카닥	tɕ͈ ɐ ɭ kʰ ɐ t ɐ k
짤카닥짤카닥	tɕ͈ ɐ ɭ kʰ ɐ t ɐ k tɕ͈ ɐ ɭ kʰ ɐ t ɐ k
짤카당	tɕ͈ ɐ ɭ kʰ ɐ t ɐ ŋ
짤카당짤카당	tɕ͈ ɐ ɭ kʰ ɐ t ɐ ŋ tɕ͈ ɐ ɭ kʰ ɐ t ɐ ŋ
짭짭	tɕ͈ ɐ p tɕ͈ ɐ p
짱	tɕ͈ ɐ ŋ
짱알짱알	tɕ͈ ɐ ŋ ɐ ɭ tɕ͈ ɐ ŋ ɐ ɭ
째긋	tɕ͈ ɛ k ɨ t
째긋째긋	tɕ͈ ɛ k ɨ t tɕ͈ ɛ k ɨ t
째까닥	tɕ͈ ɛ k͈ ɐ t ɐ k
째까닥째까닥	tɕ͈ ɛ k͈ ɐ t ɐ k tɕ͈ ɛ k͈ ɐ t ɐ k
째깍	tɕ͈ ɛ k͈ ɐ k
째깍째깍	tɕ͈ ɛ k͈ ɐ k tɕ͈ ɛ k͈ ɐ k
짹	tɕ͈ ɛ k
짹짹	tɕ͈ ɛ k tɕ͈ ɛ k
쨀쨀	tɕ͈ ɛ ɭ tɕ͈ ɛ ɭ
쨍	tɕ͈ ɛ ŋ
쨍강	tɕ͈ ɛ ŋ k ɐ ŋ
쨍강쨍강	tɕ͈ ɛ ŋ k ɐ ŋ tɕ͈ ɛ ŋ k ɐ ŋ
쨍그랑	tɕ͈ ɛ ŋ k ɨ ɭ ɐ ŋ
쨍그랑쨍그랑	tɕ͈ ɛ ŋ k ɨ ɭ ɐ ŋ tɕ͈ ɛ ŋ k ɨ ɭ ɐ ŋ
쨍긋	tɕ͈ ɛ ŋ k ɨ t
쨍긋쨍긋	tɕ͈ ɛ ŋ k ɨ t tɕ͈ ɛ ŋ k ɨ t
쨍끗	tɕ͈ ɛ ŋ k͈ ɨ t
쨍끗쨍끗	tɕ͈ ɛ ŋ k͈ ɨ t tɕ͈ ɛ ŋ k͈ ɨ t
쨍쨍	tɕ͈ ɛ ŋ tɕ͈ ɛ ŋ
쩌	tɕ͈ ʌ
쩌금쩌금	tɕ͈ ʌ k ɨ m tɕ͈ ʌ k ɨ m
쩌렁	tɕ͈ ʌ ɭ ʌ ŋ
쩌렁쩌렁	tɕ͈ ʌ ɭ ʌ ŋ tɕ͈ ʌ ɭ ʌ ŋ
쩌르렁	tɕ͈ ʌ ɭ ɨ ɭ ʌ ŋ
쩌르렁쩌르렁	tɕ͈ ʌ ɭ ɨ ɭ ʌ ŋ tɕ͈ ʌ ɭ ɨ ɭ ʌ ŋ
쩌릿쩌릿	tɕ͈ ʌ ɭ i t tɕ͈ ʌ ɭ i t
쩌벅	tɕ͈ ʌ p ʌ k
쩌벅쩌벅	tɕ͈ ʌ p ʌ k tɕ͈ ʌ p ʌ k
쩌쩌	tɕ͈ ʌ tɕ͈ ʌ
쩍	tɕ͈ ʌ k
쩍쩍	tɕ͈ ʌ k tɕ͈ ʌ k
쩔거덕	tɕ͈ ʌ ɭ k ʌ t ʌ k
쩔거덕쩔거덕	tɕ͈ ʌ ɭ k ʌ t ʌ k tɕ͈ ʌ ɭ k ʌ t ʌ k
쩔거덩	tɕ͈ ʌ ɭ k ʌ t ʌ ŋ
쩔거덩쩔거덩	tɕ͈ ʌ ɭ k ʌ t ʌ ŋ tɕ͈ ʌ ɭ k ʌ t ʌ ŋ
쩔그럭	tɕ͈ ʌ ɭ k ɨ ɭ ʌ k
쩔그럭쩔그럭	tɕ͈ ʌ ɭ k ɨ ɭ ʌ k tɕ͈ ʌ ɭ k ɨ ɭ ʌ k
쩔그렁	tɕ͈ ʌ ɭ k ɨ ɭ ʌ ŋ
쩔그렁쩔그렁	tɕ͈ ʌ ɭ k ɨ ɭ ʌ ŋ tɕ͈ ʌ ɭ k ɨ ɭ ʌ ŋ
쩔꺼덕	tɕ͈ ʌ ɭ k͈ ʌ t ʌ k
쩔꺼덕쩔꺼덕	tɕ͈ ʌ ɭ k͈ ʌ t ʌ k tɕ͈ ʌ ɭ k͈ ʌ t ʌ k
쩔꺼덩	tɕ͈ ʌ ɭ k͈ ʌ t ʌ ŋ
쩔꺼덩쩔꺼덩	tɕ͈ ʌ ɭ k͈ ʌ t ʌ ŋ tɕ͈ ʌ ɭ k͈ ʌ t ʌ ŋ
쩔뚝쩔뚝	tɕ͈ ʌ ɭ t͈ u k tɕ͈ ʌ ɭ t͈ u k
쩔렁	tɕ͈ ʌ ɭ ɭ ʌ ŋ
쩔렁쩔렁	tɕ͈ ʌ ɭ ɭ ʌ ŋ tɕ͈ ʌ ɭ ɭ ʌ ŋ
쩔레쩔레	tɕ͈ ʌ ɭ ɭ e tɕ͈ ʌ ɭ ɭ e
쩔룩쩔룩	tɕ͈ ʌ ɭ ɭ u k tɕ͈ ʌ ɭ ɭ u k
쩔름쩔름	tɕ͈ ʌ ɭ ɭ ɨ m tɕ͈ ʌ ɭ ɭ ɨ m
쩔쑥쩔쑥	tɕ͈ ʌ ɭ s͈ u k tɕ͈ ʌ ɭ s͈ u k
쩔쩔	tɕ͈ ʌ ɭ tɕ͈ ʌ ɭ
쩔커덕	tɕ͈ ʌ ɭ kʰ ʌ t ʌ k
쩔커덕쩔커덕	tɕ͈ ʌ ɭ kʰ ʌ t ʌ k tɕ͈ ʌ ɭ kʰ ʌ t ʌ k
쩔커덩	tɕ͈ ʌ ɭ kʰ ʌ t ʌ ŋ
쩔커덩쩔커덩	tɕ͈ ʌ ɭ kʰ ʌ t ʌ ŋ tɕ͈ ʌ ɭ kʰ ʌ t ʌ ŋ
쩝	tɕ͈ ʌ p
쩝쩝	tɕ͈ ʌ p tɕ͈ ʌ p
쩟	tɕ͈ ʌ t
쩟쩟	tɕ͈ ʌ t tɕ͈ ʌ t
쩡	tɕ͈ ʌ ŋ
쩡쩡	tɕ͈ ʌ ŋ tɕ͈ ʌ ŋ
쩨꺼덕	tɕ͈ e k͈ ʌ t ʌ k
쩨꺼덕쩨꺼덕	tɕ͈ e k͈ ʌ t ʌ k tɕ͈ e k͈ ʌ t ʌ k
쩨꺽	tɕ͈ e k͈ ʌ k
쩨꺽쩨꺽	tɕ͈ e k͈ ʌ k tɕ͈ e k͈ ʌ k
쩽겅	tɕ͈ e ŋ k ʌ ŋ
쩽겅쩽겅	tɕ͈ e ŋ k ʌ ŋ tɕ͈ e ŋ k ʌ ŋ
쩽그렁	tɕ͈ e ŋ k ɨ ɭ ʌ ŋ
쩽그렁쩽그렁	tɕ͈ e ŋ k ɨ ɭ ʌ ŋ tɕ͈ e ŋ k ɨ ɭ ʌ ŋ
쪼글쪼글	tɕ͈ o k ɨ ɭ tɕ͈ o k ɨ ɭ
쪼금쪼금	tɕ͈ o k ɨ m tɕ͈ o k ɨ m
쪼끔쪼끔	tɕ͈ o k͈ ɨ m tɕ͈ o k͈ ɨ m
쪼로니	tɕ͈ o ɭ o n i
쪼록	tɕ͈ o ɭ o k
쪼록쪼록	tɕ͈ o ɭ o k tɕ͈ o ɭ o k
쪼르르	tɕ͈ o ɭ ɨ ɭ ɨ
쪼르륵	tɕ͈ o ɭ ɨ ɭ ɨ k
쪼르륵쪼르륵	tɕ͈ o ɭ ɨ ɭ ɨ k tɕ͈ o ɭ ɨ ɭ ɨ k
쪼물쪼물	tɕ͈ o m u ɭ tɕ͈ o m u ɭ
쪼뼛	tɕ͈ o p͈ j ʌ t
쪼뼛쪼뼛	tɕ͈ o p͈ j ʌ t tɕ͈ o p͈ j ʌ t
쪼작	tɕ͈ o tɕ ɐ k
쪼작쪼작	tɕ͈ o tɕ ɐ k tɕ͈ o tɕ ɐ k
쪼잘쪼잘	tɕ͈ o tɕ ɐ ɭ tɕ͈ o tɕ ɐ ɭ
쪽	tɕ͈ o k
쪽잘쪽잘	tɕ͈ o k tɕ͈ ɐ ɭ tɕ͈ o k tɕ͈ ɐ ɭ
쪽쪽	tɕ͈ o k tɕ͈ o k
쫀득쫀득	tɕ͈ o n t ɨ k tɕ͈ o n t ɨ k
쫄깃쫄깃	tɕ͈ o ɭ k i t tɕ͈ o ɭ k i t
쫄끔	tɕ͈ o ɭ k͈ ɨ m
쫄끔쫄끔	tɕ͈ o ɭ k͈ ɨ m tɕ͈ o ɭ k͈ ɨ m
쫄딱쫄딱	tɕ͈ o ɭ t͈ ɐ k tɕ͈ o ɭ t͈ ɐ k
쫄랑쫄랑	tɕ͈ o ɭ ɭ ɐ ŋ tɕ͈ o ɭ ɭ ɐ ŋ
쫄래쫄래	tɕ͈ o ɭ ɭ ɛ tɕ͈ o ɭ ɭ ɛ
쫄망쫄망	tɕ͈ o ɭ m ɐ ŋ tɕ͈ o ɭ m ɐ ŋ
쫄쫄	tɕ͈ o ɭ tɕ͈ o ɭ
쫑긋	tɕ͈ o ŋ k ɨ t
쫑긋쫑긋	tɕ͈ o ŋ k ɨ t tɕ͈ o ŋ k ɨ t
쫑달쫑달	tɕ͈ o ŋ t ɐ ɭ tɕ͈ o ŋ t ɐ ɭ
쫑알쫑알	tɕ͈ o ŋ ɐ ɭ tɕ͈ o ŋ ɐ ɭ
쫑잘쫑잘	tɕ͈ o ŋ tɕ ɐ ɭ tɕ͈ o ŋ tɕ ɐ ɭ
쫑쫑	tɕ͈ o ŋ tɕ͈ o ŋ
쫘르르	tɕ͈ w ɐ ɭ ɨ ɭ ɨ
쫘르륵	tɕ͈ w ɐ ɭ ɨ ɭ ɨ k
쫘르륵쫘르륵	tɕ͈ w ɐ ɭ ɨ ɭ ɨ k tɕ͈ w ɐ ɭ ɨ ɭ ɨ k
쫙	tɕ͈ w ɐ k
쫙쫙	tɕ͈ w ɐ k tɕ͈ w ɐ k
쫠쫠	tɕ͈ w ɐ ɭ tɕ͈ w ɐ ɭ
쭈글쭈글	tɕ͈ u k ɨ ɭ tɕ͈ u k ɨ ɭ
쭈루니	tɕ͈ u ɭ u n i
쭈룩	tɕ͈ u ɭ u k
쭈룩쭈룩	tɕ͈ u ɭ u k tɕ͈ u ɭ u k
쭈르르	tɕ͈ u ɭ ɨ ɭ ɨ
쭈르륵	tɕ͈ u ɭ ɨ ɭ ɨ k
쭈르륵쭈르륵	tɕ͈ u ɭ ɨ ɭ ɨ k tɕ͈ u ɭ ɨ ɭ ɨ k
쭈물쭈물	tɕ͈ u m u ɭ tɕ͈ u m u ɭ
쭈뼛	tɕ͈ u p͈ j ʌ t
쭈뼛쭈뼛	tɕ͈ u p͈ j ʌ t tɕ͈ u p͈ j ʌ t
쭈절쭈절	tɕ͈ u tɕ ʌ ɭ tɕ͈ u tɕ ʌ ɭ
쭉	tɕ͈ u k
쭉쭉	tɕ͈ u k tɕ͈ u k
쭌득쭌득	tɕ͈ u n t ɨ k tɕ͈ u n t ɨ k
쭐깃쭐깃	tɕ͈ u ɭ k i t tɕ͈ u ɭ k i t
쭐렁쭐렁	tɕ͈ u ɭ ɭ ʌ ŋ tɕ͈ u ɭ ɭ ʌ ŋ
쭐레쭐레	tɕ͈ u ɭ ɭ e tɕ͈ u ɭ ɭ e
쭐룩쭐룩	tɕ͈ u ɭ ɭ u k tɕ͈ u ɭ ɭ u k
쭐멍쭐멍	tɕ͈ u ɭ m ʌ ŋ tɕ͈ u ɭ m ʌ ŋ
쭐쭐	tɕ͈ u ɭ tɕ͈ u ɭ
쭝긋	tɕ͈ u ŋ k ɨ t
쭝긋쭝긋	tɕ͈ u ŋ k ɨ t tɕ͈ u ŋ k ɨ t
쭝덜쭝덜	tɕ͈ u ŋ t ʌ ɭ tɕ͈ u ŋ t ʌ ɭ
쭝얼쭝얼	tɕ͈ u ŋ ʌ ɭ tɕ͈ u ŋ ʌ ɭ
쭝절쭝절	tɕ͈ u ŋ tɕ ʌ ɭ tɕ͈ u ŋ tɕ ʌ ɭ
쯧	tɕ͈ ɨ t
쯧쯧	tɕ͈ ɨ t tɕ͈ ɨ t
찌걱	tɕ͈ i k ʌ k
찌걱찌걱	tɕ͈ i k ʌ k tɕ͈ i k ʌ k
찌그둥	tɕ͈ i k ɨ t u ŋ
찌그럭찌그럭	tɕ͈ i k ɨ ɭ ʌ k tɕ͈ i k ɨ ɭ ʌ k
찌그르르	tɕ͈ i k ɨ ɭ ɨ ɭ ɨ
찌근덕찌근덕	tɕ͈ i k ɨ n t ʌ k tɕ͈ i k ɨ n t ʌ k
찌근찌근	tɕ͈ i k ɨ n tɕ͈ i k ɨ n
찌글찌글	tɕ͈ i k ɨ ɭ tɕ͈ i k ɨ ɭ
찌긋	tɕ͈ i k ɨ t
찌긋찌긋	tɕ͈ i k ɨ t tɕ͈ i k ɨ t
찌꺽	tɕ͈ i k͈ ʌ k
찌꺽찌꺽	tɕ͈ i k͈ ʌ k tɕ͈ i k͈ ʌ k
찌덕찌덕	tɕ͈ i t ʌ k tɕ͈ i t ʌ k
찌드럭찌드럭	tɕ͈ i t ɨ ɭ ʌ k tɕ͈ i t ɨ ɭ ʌ k
찌득찌득	tɕ͈ i t ɨ k tɕ͈ i t ɨ k
찌들름찌들름	tɕ͈ i t ɨ ɭ ɭ ɨ m tɕ͈ i t ɨ ɭ ɭ ɨ m
찌뜰름찌뜰름	tɕ͈ i t͈ ɨ ɭ ɭ ɨ m tɕ͈ i t͈ ɨ ɭ ɭ ɨ m
찌르르	tɕ͈ i ɭ ɨ ɭ ɨ
찌르륵	tɕ͈ i ɭ ɨ ɭ ɨ k
찌르륵찌르륵	tɕ͈ i ɭ ɨ ɭ ɨ k tɕ͈ i ɭ ɨ ɭ ɨ k
찌르릉	tɕ͈ i ɭ ɨ ɭ ɨ ŋ
찌르릉찌르릉	tɕ͈ i ɭ ɨ ɭ ɨ ŋ tɕ͈ i ɭ ɨ ɭ ɨ ŋ
찌릿찌릿	tɕ͈ i ɭ i t tɕ͈ i ɭ i t
찌뻑찌뻑	tɕ͈ i p͈ ʌ k tɕ͈ i p͈ ʌ k
찌뿌드드	tɕ͈ i p͈ u t ɨ t ɨ
찍	tɕ͈ i k
찍찍	tɕ͈ i k tɕ͈ i k
찐득찐득	tɕ͈ i n t ɨ k tɕ͈ i n t ɨ k
찔긋	tɕ͈ i ɭ k ɨ t
찔깃찔깃	tɕ͈ i ɭ k i t tɕ͈ i ɭ k i t
찔꺽찔꺽	tɕ͈ i ɭ k͈ ʌ k tɕ͈ i ɭ k͈ ʌ k
찔끔	tɕ͈ i ɭ k͈ ɨ m
찔끔찔끔	tɕ͈ i ɭ k͈ ɨ m tɕ͈ i ɭ k͈ ɨ m
찔뚝찔뚝	tɕ͈ i ɭ t͈ u k tɕ͈ i ɭ t͈ u k
찔룩	tɕ͈ i ɭ ɭ u k
찔룩찔룩	tɕ͈ i ɭ ɭ u k tɕ͈ i ɭ ɭ u k
찔름찔름	tɕ͈ i ɭ ɭ ɨ m tɕ͈ i ɭ ɭ ɨ m
찔쑥찔쑥	tɕ͈ i ɭ s͈ u k tɕ͈ i ɭ s͈ u k
찔찔	tɕ͈ i ɭ tɕ͈ i ɭ
찝쩍찝쩍	tɕ͈ i p tɕ͈ ʌ k tɕ͈ i p tɕ͈ ʌ k
찡	tɕ͈ i ŋ
찡검찡검	tɕ͈ i ŋ k ʌ m tɕ͈ i ŋ k ʌ m
찡긋	tɕ͈ i ŋ k ɨ t
찡긋찡긋	tɕ͈ i ŋ k ɨ t tɕ͈ i ŋ k ɨ t
찡끗	tɕ͈ i ŋ k͈ ɨ t
찡끗찡끗	tɕ͈ i ŋ k͈ ɨ t tɕ͈ i ŋ k͈ ɨ t
찡얼찡얼	tɕ͈ i ŋ ʌ ɭ tɕ͈ i ŋ ʌ ɭ
찡찡	tɕ͈ i ŋ tɕ͈ i ŋ
차곡차곡	tɕʰ ɐ k o k tɕʰ ɐ k o k
차근덕차근덕	tɕʰ ɐ k ɨ n t ʌ k tɕʰ ɐ k ɨ n t ʌ k
차근차근	tɕʰ ɐ k ɨ n tɕʰ ɐ k ɨ n
차닥차닥	tɕʰ ɐ t ɐ k tɕʰ ɐ t ɐ k
차락차락	tɕʰ ɐ ɭ ɐ k tɕʰ ɐ ɭ ɐ k
차란차란	tɕʰ ɐ ɭ ɐ n tɕʰ ɐ ɭ ɐ n
차랑	tɕʰ ɐ ɭ ɐ ŋ
차랑차랑	tɕʰ ɐ ɭ ɐ ŋ tɕʰ ɐ ɭ ɐ ŋ
차르랑	tɕʰ ɐ ɭ ɨ ɭ ɐ ŋ
차르랑차르랑	tɕʰ ɐ ɭ ɨ ɭ ɐ ŋ tɕʰ ɐ ɭ ɨ ɭ ɐ ŋ
차분차분	tɕʰ ɐ p u n tɕʰ ɐ p u n
차즘	tɕʰ ɐ tɕ ɨ m
차즘차즘	tɕʰ ɐ tɕ ɨ m tɕʰ ɐ tɕ ɨ m
차츰	tɕʰ ɐ tɕʰ ɨ m
차츰차츰	tɕʰ ɐ tɕʰ ɨ m tɕʰ ɐ tɕʰ ɨ m
착	tɕʰ ɐ k
착착	tɕʰ ɐ k tɕʰ ɐ k
찬찬	tɕʰ ɐ n tɕʰ ɐ n
찰가닥	tɕʰ ɐ ɭ k ɐ t ɐ k
찰가닥찰가닥	tɕʰ ɐ ɭ k ɐ t ɐ k tɕʰ ɐ ɭ k ɐ t ɐ k
찰가당	tɕʰ ɐ ɭ k ɐ t ɐ ŋ
찰가당찰가당	tɕʰ ɐ ɭ k ɐ t ɐ ŋ tɕʰ ɐ ɭ k ɐ t ɐ ŋ
찰그랑	tɕʰ ɐ ɭ k ɨ ɭ ɐ ŋ
찰그랑찰그랑	tɕʰ ɐ ɭ k ɨ ɭ ɐ ŋ tɕʰ ɐ ɭ k ɨ ɭ ɐ ŋ
찰까닥	tɕʰ ɐ ɭ k͈ ɐ t ɐ k
찰까닥찰까닥	tɕʰ ɐ ɭ k͈ ɐ t ɐ k tɕʰ ɐ ɭ k͈ ɐ t ɐ k
찰까당	tɕʰ ɐ ɭ k͈ ɐ t ɐ ŋ
찰까당찰까당	tɕʰ ɐ ɭ k͈ ɐ t ɐ ŋ tɕʰ ɐ ɭ k͈ ɐ t ɐ ŋ
찰딱	tɕʰ ɐ ɭ t͈ ɐ k
찰딱찰딱	tɕʰ ɐ ɭ t͈ ɐ k tɕʰ ɐ ɭ t͈ ɐ k
찰락	tɕʰ ɐ ɭ ɭ ɐ k
찰락찰락	tɕʰ ɐ ɭ ɭ ɐ k tɕʰ ɐ ɭ ɭ ɐ k
찰람	tɕʰ ɐ ɭ ɭ ɐ m
찰람찰람	tɕʰ ɐ ɭ ɭ ɐ m tɕʰ ɐ ɭ ɭ ɐ m
찰랑	tɕʰ ɐ ɭ ɭ ɐ ŋ
찰랑찰랑	tɕʰ ɐ ɭ ɭ ɐ ŋ tɕʰ ɐ ɭ ɭ ɐ ŋ
찰래찰래	tɕʰ ɐ ɭ ɭ ɛ tɕʰ ɐ ɭ ɭ ɛ
찰바닥	tɕʰ ɐ ɭ p ɐ t ɐ k
찰바닥찰바닥	tɕʰ ɐ ɭ p ɐ t ɐ k tɕʰ ɐ ɭ p ɐ t ɐ k
찰바당	tɕʰ ɐ ɭ p ɐ t ɐ ŋ
찰바당찰바당	tɕʰ ɐ ɭ p ɐ t ɐ ŋ tɕʰ ɐ ɭ p ɐ t ɐ ŋ
찰싸닥	tɕʰ ɐ ɭ s͈ ɐ t ɐ k
찰싸닥찰싸닥	tɕʰ ɐ ɭ s͈ ɐ t ɐ k tɕʰ ɐ ɭ s͈ ɐ t ɐ k
찰싹	tɕʰ ɐ ɭ s͈ ɐ k
찰싹찰싹	tɕʰ ɐ ɭ s͈ ɐ k tɕʰ ɐ ɭ s͈ ɐ k
찰찰	tɕʰ ɐ ɭ tɕʰ ɐ ɭ
찰카닥	tɕʰ ɐ ɭ kʰ ɐ t ɐ k
찰카닥찰카닥	tɕʰ ɐ ɭ kʰ ɐ t ɐ k tɕʰ ɐ ɭ kʰ ɐ t ɐ k
찰카당	tɕʰ ɐ ɭ kʰ ɐ t ɐ ŋ
찰카당찰카당	tɕʰ ɐ ɭ kʰ ɐ t ɐ ŋ tɕʰ ɐ ɭ kʰ ɐ t ɐ ŋ
찰파닥	tɕʰ ɐ ɭ pʰ ɐ t ɐ k
찰파닥찰파닥	tɕʰ ɐ ɭ pʰ ɐ t ɐ k tɕʰ ɐ ɭ pʰ ɐ t ɐ k
참방	tɕʰ ɐ m p ɐ ŋ
참방참방	tɕʰ ɐ m p ɐ ŋ tɕʰ ɐ m p ɐ ŋ
창알창알	tɕʰ ɐ ŋ ɐ ɭ tɕʰ ɐ ŋ ɐ ɭ
챙챙	tɕʰ ɛ ŋ tɕʰ ɛ ŋ
처근처근	tɕʰ ʌ k ɨ n tɕʰ ʌ k ɨ n
처덕처덕	tɕʰ ʌ t ʌ k tɕʰ ʌ t ʌ k
처렁	tɕʰ ʌ ɭ ʌ ŋ
처렁처렁	tɕʰ ʌ ɭ ʌ ŋ tɕʰ ʌ ɭ ʌ ŋ
처르렁	tɕʰ ʌ ɭ ɨ ɭ ʌ ŋ
처르렁처르렁	tɕʰ ʌ ɭ ɨ ɭ ʌ ŋ tɕʰ ʌ ɭ ɨ ɭ ʌ ŋ
척	tɕʰ ʌ k
척척	tɕʰ ʌ k tɕʰ ʌ k
천덩천덩	tɕʰ ʌ n t ʌ ŋ tɕʰ ʌ n t ʌ ŋ
철거덕	tɕʰ ʌ ɭ k ʌ t ʌ k
철거덕철거덕	tɕʰ ʌ ɭ k ʌ t ʌ k tɕʰ ʌ ɭ k ʌ t ʌ k
철거덩	tɕʰ ʌ ɭ k ʌ t ʌ ŋ
철거덩철거덩	tɕʰ ʌ ɭ k ʌ t ʌ ŋ tɕʰ ʌ ɭ k ʌ t ʌ ŋ
철그렁	tɕʰ ʌ ɭ k ɨ ɭ ʌ ŋ
철그렁철그렁	tɕʰ ʌ ɭ k ɨ ɭ ʌ ŋ tɕʰ ʌ ɭ k ɨ ɭ ʌ ŋ
철꺼덕	tɕʰ ʌ ɭ k͈ ʌ t ʌ k
철꺼덕철꺼덕	tɕʰ ʌ ɭ k͈ ʌ t ʌ k tɕʰ ʌ ɭ k͈ ʌ t ʌ k
철꺼덩	tɕʰ ʌ ɭ k͈ ʌ t ʌ ŋ
철꺼덩철꺼덩	tɕʰ ʌ ɭ k͈ ʌ t ʌ ŋ tɕʰ ʌ ɭ k͈ ʌ t ʌ ŋ
철떡	tɕʰ ʌ ɭ t͈ ʌ k
철떡철떡	tɕʰ ʌ ɭ t͈ ʌ k tɕʰ ʌ ɭ t͈ ʌ k
철럭	tɕʰ ʌ ɭ ɭ ʌ k
철럭철럭	tɕʰ ʌ ɭ ɭ ʌ k tɕʰ ʌ ɭ ɭ ʌ k
철럼	tɕʰ ʌ ɭ ɭ ʌ m
철럼철럼	tɕʰ ʌ ɭ ɭ ʌ m tɕʰ ʌ ɭ ɭ ʌ m
철렁	tɕʰ ʌ ɭ ɭ ʌ ŋ
철렁철렁	tɕʰ ʌ ɭ ɭ ʌ ŋ tɕʰ ʌ ɭ ɭ ʌ ŋ
철버덕	tɕʰ ʌ ɭ p ʌ t ʌ k
철버덕철버덕	tɕʰ ʌ ɭ p ʌ t ʌ k tɕʰ ʌ ɭ p ʌ t ʌ k
철버덩	tɕʰ ʌ ɭ p ʌ t ʌ ŋ
철버덩철버덩	tɕʰ ʌ ɭ p ʌ t ʌ ŋ tɕʰ ʌ ɭ p ʌ t ʌ ŋ
철써덕	tɕʰ ʌ ɭ s͈ ʌ t ʌ k
철써덕철써덕	tɕʰ ʌ ɭ s͈ ʌ t ʌ k tɕʰ ʌ ɭ s͈ ʌ t ʌ k
철철	tɕʰ ʌ ɭ tɕʰ ʌ ɭ
철커덕	tɕʰ ʌ ɭ kʰ ʌ t ʌ k
철커덕철커덕	tɕʰ ʌ ɭ kʰ ʌ t ʌ k tɕʰ ʌ ɭ kʰ ʌ t ʌ k
철커덩	tɕʰ ʌ ɭ kʰ ʌ t ʌ ŋ
철커덩철커덩	tɕʰ ʌ ɭ kʰ ʌ t ʌ ŋ tɕʰ ʌ ɭ kʰ ʌ t ʌ ŋ
철퍼덕	tɕʰ ʌ ɭ pʰ ʌ t ʌ k
철퍼덕철퍼덕	tɕʰ ʌ ɭ pʰ ʌ t ʌ k tɕʰ ʌ ɭ pʰ ʌ t ʌ k
첨벙	tɕʰ ʌ m p ʌ ŋ
첨벙첨벙	tɕʰ ʌ m p ʌ ŋ tɕʰ ʌ m p ʌ ŋ
초군초군	tɕʰ o k u n tɕʰ o k u n
초근초근	tɕʰ o k ɨ n tɕʰ o k ɨ n
초롱초롱	tɕʰ o ɭ o ŋ tɕʰ o ɭ o ŋ
초싹초싹	tɕʰ o s͈ ɐ k tɕʰ o s͈ ɐ k
촉	tɕʰ o k
촉촉	tɕʰ o k tɕʰ o k
촐랑촐랑	tɕʰ o ɭ ɭ ɐ ŋ tɕʰ o ɭ ɭ ɐ ŋ
촐싹촐싹	tɕʰ o ɭ s͈ ɐ k tɕʰ o ɭ s͈ ɐ k
촐촐	tɕʰ o ɭ tɕʰ o ɭ
총총	tɕʰ o ŋ tɕʰ o ŋ
추근추근	tɕʰ u k ɨ n tɕʰ u k ɨ n
추썩추썩	tɕʰ u s͈ ʌ k tɕʰ u s͈ ʌ k
추적추적	tɕʰ u tɕ ʌ k tɕʰ u tɕ ʌ k
축	tɕʰ u k
축축	tɕʰ u k tɕʰ u k
출렁	tɕʰ u ɭ ɭ ʌ ŋ
출렁출렁	tɕʰ u ɭ ɭ ʌ ŋ tɕʰ u ɭ ɭ ʌ ŋ
출썩출썩	tɕʰ u ɭ s͈ ʌ k tɕʰ u ɭ s͈ ʌ k
출출	tɕʰ u ɭ tɕʰ u ɭ
충충	tɕʰ u ŋ tɕʰ u ŋ
치근덕치근덕	tɕʰ i k ɨ n t ʌ k tɕʰ i k ɨ n t ʌ k
치근치근	tɕʰ i k ɨ n tɕʰ i k ɨ n
치덕치덕	tɕʰ i t ʌ k tɕʰ i t ʌ k
치런치런	tɕʰ i ɭ ʌ n tɕʰ i ɭ ʌ n
치렁치렁	tɕʰ i ɭ ʌ ŋ tɕʰ i ɭ ʌ ŋ
치르르	tɕʰ i ɭ ɨ ɭ ɨ
칙칙	tɕʰ i k tɕʰ i k
칙칙폭폭	tɕʰ i k tɕʰ i k pʰ o k pʰ o k
친친	tɕʰ i n tɕʰ i n
칠떡칠떡	tɕʰ i ɭ t͈ ʌ k tɕʰ i ɭ t͈ ʌ k
칠럼	tɕʰ i ɭ ɭ ʌ m
칠럼칠럼	tɕʰ i ɭ ɭ ʌ m tɕʰ i ɭ ɭ ʌ m
칠렁칠렁	tɕʰ i ɭ ɭ ʌ ŋ tɕʰ i ɭ ɭ ʌ ŋ
칭얼칭얼	tɕʰ i ŋ ʌ ɭ tɕʰ i ŋ ʌ ɭ
칭칭	tɕʰ i ŋ tɕʰ i ŋ
카	kʰ ɐ
카랑카랑	kʰ ɐ ɭ ɐ ŋ kʰ ɐ ɭ ɐ ŋ
카악	kʰ ɐ ɐ k
칵	kʰ ɐ k
칵칵	kʰ ɐ k kʰ ɐ k
칼락	kʰ ɐ ɭ ɭ ɐ k
칼락칼락	kʰ ɐ ɭ ɭ ɐ k kʰ ɐ ɭ ɭ ɐ k
캄캄	kʰ ɐ m kʰ ɐ m
캉	kʰ ɐ ŋ
캉캉	kʰ ɐ ŋ kʰ ɐ ŋ
캐드득	kʰ ɛ t ɨ t ɨ k
캐드득캐드득	kʰ ɛ t ɨ t ɨ k kʰ ɛ t ɨ t ɨ k
캐들캐들	kʰ ɛ t ɨ ɭ kʰ ɛ t ɨ ɭ
캑	kʰ ɛ k
캑캑	kʰ ɛ k kʰ ɛ k
캘캘	kʰ ɛ ɭ kʰ ɛ ɭ
캥	kʰ ɛ ŋ
캥캥	kʰ ɛ ŋ kʰ ɛ ŋ
캭	kʰ j ɐ k
캭캭	kʰ j ɐ k kʰ j ɐ k
캴캴	kʰ j ɐ ɭ kʰ j ɐ ɭ
컁	kʰ j ɐ ŋ
컁컁	kʰ j ɐ ŋ kʰ j ɐ ŋ
커	kʰ ʌ
컥	kʰ ʌ k
컥컥	kʰ ʌ k kʰ ʌ k
컬럭	kʰ ʌ ɭ ɭ ʌ k
컬럭컬럭	kʰ ʌ ɭ ɭ ʌ k kʰ ʌ ɭ ɭ ʌ k
컹컹	kʰ ʌ ŋ kʰ ʌ ŋ
코랑코랑	kʰ o ɭ ɐ ŋ kʰ o ɭ ɐ ŋ
콕	kʰ o k
콕콕	kʰ o k kʰ o k
콜랑	kʰ o ɭ ɭ ɐ ŋ
콜랑콜랑	kʰ o ɭ ɭ ɐ ŋ kʰ o ɭ ɭ ɐ ŋ
콜록	kʰ o ɭ ɭ o k
콜록콜록	kʰ o ɭ ɭ o k kʰ o ɭ ɭ o k
콜콜	kʰ o ɭ kʰ o ɭ
콩	kʰ o ŋ
콩다콩	kʰ o ŋ t ɐ kʰ o ŋ
콩다콩콩다콩	kʰ o ŋ t ɐ kʰ o ŋ kʰ o ŋ t ɐ kʰ o ŋ
콩닥	kʰ o ŋ t ɐ k
콩닥닥	kʰ o ŋ t ɐ k t͈ ɐ k
콩닥닥콩닥닥	kʰ o ŋ t ɐ k t͈ ɐ k kʰ o ŋ t ɐ k t͈ ɐ k
콩닥콩닥	kʰ o ŋ t ɐ k kʰ o ŋ t ɐ k
콩작	kʰ o ŋ tɕ ɐ k
콩작작	kʰ o ŋ tɕ ɐ k tɕ͈ ɐ k
콩작작콩작작	kʰ o ŋ tɕ ɐ k tɕ͈ ɐ k kʰ o ŋ tɕ ɐ k tɕ͈ ɐ k
콩작콩	kʰ o ŋ tɕ ɐ k kʰ o ŋ
콩작콩작	kʰ o ŋ tɕ ɐ k kʰ o ŋ tɕ ɐ k
콩작콩콩작콩	kʰ o ŋ tɕ ɐ k kʰ o ŋ kʰ o ŋ tɕ ɐ k kʰ o ŋ
콩콩	kʰ o ŋ kʰ o ŋ
콩팔칠팔	kʰ o ŋ pʰ ɐ ɭ tɕʰ i ɭ pʰ ɐ ɭ
콰르르	kʰ w ɐ ɭ ɨ ɭ ɨ
콰르릉	kʰ w ɐ ɭ ɨ ɭ ɨ ŋ
콰르릉콰르릉	kʰ w ɐ ɭ ɨ ɭ ɨ ŋ kʰ w ɐ ɭ ɨ ɭ ɨ ŋ
콱	kʰ w ɐ k
콱콱	kʰ w ɐ k kʰ w ɐ k
콸콸	kʰ w ɐ ɭ kʰ w ɐ ɭ
쾅	kʰ w ɐ ŋ
쾅쾅	kʰ w ɐ ŋ kʰ w ɐ ŋ
쿠당탕	kʰ u t ɐ ŋ tʰ ɐ ŋ
쿠렁쿠렁	kʰ u ɭ ʌ ŋ kʰ u ɭ ʌ ŋ
쿡	kʰ u k
쿡쿡	kʰ u k kʰ u k
쿨럭	kʰ u ɭ ɭ ʌ k
쿨럭쿨럭	kʰ u ɭ ɭ ʌ k kʰ u ɭ ɭ ʌ k
쿨렁	kʰ u ɭ ɭ ʌ ŋ
쿨렁쿨렁	kʰ u ɭ ɭ ʌ ŋ kʰ u ɭ ɭ ʌ ŋ
쿨룩	kʰ u ɭ ɭ u k
쿨룩쿨룩	kʰ u ɭ ɭ u k kʰ u ɭ ɭ u k
쿨쿨	kʰ u ɭ kʰ u ɭ
쿵	kʰ u ŋ
쿵더쿵	kʰ u ŋ t ʌ kʰ u ŋ
쿵더쿵쿵더쿵	kʰ u ŋ t ʌ kʰ u ŋ kʰ u ŋ t ʌ kʰ u ŋ
쿵덕	kʰ u ŋ t ʌ k
쿵덕덕	kʰ u ŋ t ʌ k t͈ ʌ k
쿵덕덕쿵덕덕	kʰ u ŋ t ʌ k t͈ ʌ k kʰ u ŋ t ʌ k t͈ ʌ k
쿵덕쿵덕	kʰ u ŋ t ʌ k kʰ u ŋ t ʌ k
쿵작쿵작	kʰ u ŋ tɕ ɐ k kʰ u ŋ tɕ ɐ k
쿵적	kʰ u ŋ tɕ ʌ k
쿵적적	kʰ u ŋ tɕ ʌ k tɕ͈ ʌ k
쿵적적쿵적적	kʰ u ŋ tɕ ʌ k tɕ͈ ʌ k kʰ u ŋ tɕ ʌ k tɕ͈ ʌ k
쿵적쿵	kʰ u ŋ tɕ ʌ k kʰ u ŋ
쿵적쿵적	kʰ u ŋ tɕ ʌ k kʰ u ŋ tɕ ʌ k
쿵적쿵쿵적쿵	kʰ u ŋ tɕ ʌ k kʰ u ŋ kʰ u ŋ tɕ ʌ k kʰ u ŋ
쿵쾅	kʰ u ŋ kʰ w ɐ ŋ
쿵쾅쿵쾅	kʰ u ŋ kʰ w ɐ ŋ kʰ u ŋ kʰ w ɐ ŋ
쿵쿵	kʰ u ŋ kʰ u ŋ
쿼르르	kʰ w ʌ ɭ ɨ ɭ ɨ
퀄퀄	kʰ w ʌ ɭ kʰ w ʌ ɭ
퀑	kʰ w ʌ ŋ
퀑퀑	kʰ w ʌ ŋ kʰ w ʌ ŋ
크렁크렁	kʰ ɨ ɭ ʌ ŋ kʰ ɨ ɭ ʌ ŋ
큼직큼직	kʰ ɨ m tɕ i k kʰ ɨ m tɕ i k
큼큼	kʰ ɨ m kʰ ɨ m
킁킁	kʰ ɨ ŋ kʰ ɨ ŋ
키드득	kʰ i t ɨ t ɨ k
키드득키드득	kʰ i t ɨ t ɨ k kʰ i t ɨ t ɨ k
키들키들	kʰ i t ɨ ɭ kʰ i t ɨ ɭ
킬킬	kʰ i ɭ kʰ i ɭ
킹	kʰ i ŋ
킹킹	kʰ i ŋ kʰ i ŋ
타다닥	tʰ ɐ t ɐ t ɐ k
타다닥타다닥	tʰ ɐ t ɐ t ɐ k tʰ ɐ t ɐ t ɐ k
타닥타닥	tʰ ɐ t ɐ k tʰ ɐ t ɐ k
타달타달	tʰ ɐ t ɐ ɭ tʰ ɐ t ɐ ɭ
타드락타드락	tʰ ɐ t ɨ ɭ ɐ k tʰ ɐ t ɨ ɭ ɐ k
타드랑	tʰ ɐ t ɨ ɭ ɐ ŋ
타드랑타드랑	tʰ ɐ t ɨ ɭ ɐ ŋ tʰ ɐ t ɨ ɭ ɐ ŋ
타래타래	tʰ ɐ ɭ ɛ tʰ ɐ ɭ ɛ
타박타박	tʰ ɐ p ɐ k tʰ ɐ p ɐ k
타발타발	tʰ ɐ p ɐ ɭ tʰ ɐ p ɐ ɭ
타시락타시락	tʰ ɐ s i ɭ ɐ k tʰ ɐ s i ɭ ɐ k
타울타울	tʰ ɐ u ɭ tʰ ɐ u ɭ
탁	tʰ ɐ k
탁탁	tʰ ɐ k tʰ ɐ k
탈가닥	tʰ ɐ ɭ k ɐ t ɐ k
탈가닥탈가닥	tʰ ɐ ɭ k ɐ t ɐ k tʰ ɐ ɭ k ɐ t ɐ k
탈가당	tʰ ɐ ɭ k ɐ t ɐ ŋ
탈가당탈가당	tʰ ɐ ɭ k ɐ t ɐ ŋ tʰ ɐ ɭ k ɐ t ɐ ŋ
탈락	tʰ ɐ ɭ ɭ ɐ k
탈락탈락	tʰ ɐ ɭ ɭ ɐ k tʰ ɐ ɭ ɭ ɐ k
탈랑	tʰ ɐ ɭ ɭ ɐ ŋ
탈랑탈랑	tʰ ɐ ɭ ɭ ɐ ŋ tʰ ɐ ɭ ɭ ɐ ŋ
탈래탈래	tʰ ɐ ɭ ɭ ɛ tʰ ɐ ɭ ɭ ɛ
탈바닥	tʰ ɐ ɭ p ɐ t ɐ k
탈바닥탈바닥	tʰ ɐ ɭ p ɐ t ɐ k tʰ ɐ ɭ p ɐ t ɐ k
탈바당	tʰ ɐ ɭ p ɐ t ɐ ŋ
탈바당탈바당	tʰ ɐ ɭ p ɐ t ɐ ŋ tʰ ɐ ɭ p ɐ t ɐ ŋ
탈싹	tʰ ɐ ɭ s͈ ɐ k
탈싹탈싹	tʰ ɐ ɭ s͈ ɐ k tʰ ɐ ɭ s͈ ɐ k
탈카닥	tʰ ɐ ɭ kʰ ɐ t ɐ k
탈카닥탈카닥	tʰ ɐ ɭ kʰ ɐ t ɐ k tʰ ɐ ɭ kʰ ɐ t ɐ k
탈카당	tʰ ɐ ɭ kʰ ɐ t ɐ ŋ
탈카당탈카당	tʰ ɐ ɭ kʰ ɐ t ɐ ŋ tʰ ɐ ɭ kʰ ɐ t ɐ ŋ
탈탈	tʰ ɐ ɭ tʰ ɐ ɭ
탈파닥	tʰ ɐ ɭ pʰ ɐ t ɐ k
탈파닥탈파닥	tʰ ɐ ɭ pʰ ɐ t ɐ k tʰ ɐ ɭ pʰ ɐ t ɐ k
탐방	tʰ ɐ m p ɐ ŋ
탐방탐방	tʰ ɐ m p ɐ ŋ tʰ ɐ m p ɐ ŋ
탑삭	tʰ ɐ p s͈ ɐ k
탑삭탑삭	tʰ ɐ p s͈ ɐ k tʰ ɐ p s͈ ɐ k
탕	tʰ ɐ ŋ
탕탕	tʰ ɐ ŋ tʰ ɐ ŋ
탱글탱글	tʰ ɛ ŋ k ɨ ɭ tʰ ɛ ŋ k ɨ ɭ
탱자탱자	tʰ ɛ ŋ tɕ ɐ tʰ ɛ ŋ tɕ ɐ
탱탱	tʰ ɛ ŋ tʰ ɛ ŋ
터덕터덕	tʰ ʌ t ʌ k tʰ ʌ t ʌ k
터덜터덜	tʰ ʌ t ʌ ɭ tʰ ʌ t ʌ ɭ
터드럭터드럭	tʰ ʌ t ɨ ɭ ʌ k tʰ ʌ t ɨ ɭ ʌ k
터드렁	tʰ ʌ t ɨ ɭ ʌ ŋ
터드렁터드렁	tʰ ʌ t ɨ ɭ ʌ ŋ tʰ ʌ t ɨ ɭ ʌ ŋ
터벅터벅	tʰ ʌ p ʌ k tʰ ʌ p ʌ k
터벌터벌	tʰ ʌ p ʌ ɭ tʰ ʌ p ʌ ɭ
터부룩터부룩	tʰ ʌ p u ɭ u k tʰ ʌ p u ɭ u k
터실터실	tʰ ʌ s i ɭ tʰ ʌ s i ɭ
터울터울	tʰ ʌ u ɭ tʰ ʌ u ɭ
턱	tʰ ʌ k
턱턱	tʰ ʌ k tʰ ʌ k
털거덕	tʰ ʌ ɭ k ʌ t ʌ k
털거덕털거덕	tʰ ʌ ɭ k ʌ t ʌ k tʰ ʌ ɭ k ʌ t ʌ k
털거덩	tʰ ʌ ɭ k ʌ t ʌ ŋ
털거덩털거덩	tʰ ʌ ɭ k ʌ t ʌ ŋ tʰ ʌ ɭ k ʌ t ʌ ŋ
털럭	tʰ ʌ ɭ ɭ ʌ k
털럭털럭	tʰ ʌ ɭ ɭ ʌ k tʰ ʌ ɭ ɭ ʌ k
털렁	tʰ ʌ ɭ ɭ ʌ ŋ
털렁털렁	tʰ ʌ ɭ ɭ ʌ ŋ tʰ ʌ ɭ ɭ ʌ ŋ
털레털레	tʰ ʌ ɭ ɭ e tʰ ʌ ɭ ɭ e
털버덕	tʰ ʌ ɭ p ʌ t ʌ k
털버덕털버덕	tʰ ʌ ɭ p ʌ t ʌ k tʰ ʌ ɭ p ʌ t ʌ k
털버덩	tʰ ʌ ɭ p ʌ t ʌ ŋ
털버덩털버덩	tʰ ʌ ɭ p ʌ t ʌ ŋ tʰ ʌ ɭ p ʌ t ʌ ŋ
털썩	tʰ ʌ ɭ s͈ ʌ k
털썩털썩	tʰ ʌ ɭ s͈ ʌ k tʰ ʌ ɭ s͈ ʌ k
털커덕	tʰ ʌ ɭ kʰ ʌ t ʌ k
털커덕털커덕	tʰ ʌ ɭ kʰ ʌ t ʌ k tʰ ʌ ɭ kʰ ʌ t ʌ k
털커덩	tʰ ʌ ɭ kʰ ʌ t ʌ ŋ
털커덩털커덩	tʰ ʌ ɭ kʰ ʌ t ʌ ŋ tʰ ʌ ɭ kʰ ʌ t ʌ ŋ
털컥	tʰ ʌ ɭ kʰ ʌ k
털컥털컥	tʰ ʌ ɭ kʰ ʌ k tʰ ʌ ɭ kʰ ʌ k
털털	tʰ ʌ ɭ tʰ ʌ ɭ
털퍼덕	tʰ ʌ ɭ pʰ ʌ t ʌ k
털퍼덕털퍼덕	tʰ ʌ ɭ pʰ ʌ t ʌ k tʰ ʌ ɭ pʰ ʌ t ʌ k
텀벙	tʰ ʌ m p ʌ ŋ
텀벙텀벙	tʰ ʌ m p ʌ ŋ tʰ ʌ m p ʌ ŋ
텁석	tʰ ʌ p s͈ ʌ k
텁석텁석	tʰ ʌ p s͈ ʌ k tʰ ʌ p s͈ ʌ k
텅	tʰ ʌ ŋ
텅텅	tʰ ʌ ŋ tʰ ʌ ŋ
테석테석	tʰ e s ʌ k tʰ e s ʌ k
토닥토닥	tʰ o t ɐ k tʰ o t ɐ k
토도독	tʰ o t o t o k
토도독토도독	tʰ o t o t o k tʰ o t o t o k
토동통	tʰ o t o ŋ tʰ o ŋ
토드락토드락	tʰ o t ɨ ɭ ɐ k tʰ o t ɨ ɭ ɐ k
토실토실	tʰ o s i ɭ tʰ o s i ɭ
톡	tʰ o k
톡탁	tʰ o k tʰ ɐ k
톡탁톡탁	tʰ o k tʰ ɐ k tʰ o k tʰ ɐ k
톡톡	tʰ o k tʰ o k
톰방	tʰ o m p ɐ ŋ
톰방톰방	tʰ o m p ɐ ŋ tʰ o m p ɐ ŋ
통	tʰ o ŋ
통탕	tʰ o ŋ tʰ ɐ ŋ
통탕통탕	tʰ o ŋ tʰ ɐ ŋ tʰ o ŋ tʰ ɐ ŋ
통통	tʰ o ŋ tʰ o ŋ
투덕투덕	tʰ u t ʌ k tʰ u t ʌ k
투덜투덜	tʰ u t ʌ ɭ tʰ u t ʌ ɭ
투두둑	tʰ u t u t u k
투두둑투두둑	tʰ u t u t u k tʰ u t u t u k
투둑투둑	tʰ u t u k tʰ u t u k
투드럭투드럭	tʰ u t ɨ ɭ ʌ k tʰ u t ɨ ɭ ʌ k
투루루	tʰ u ɭ u ɭ u
투실투실	tʰ u s i ɭ tʰ u s i ɭ
투투	tʰ u tʰ u
툭	tʰ u k
툭탁	tʰ u k tʰ ɐ k
툭탁툭탁	tʰ u k tʰ ɐ k tʰ u k tʰ ɐ k
툭툭	tʰ u k tʰ u k
툴툴	tʰ u ɭ tʰ u ɭ
툼벙	tʰ u m p ʌ ŋ
툼벙툼벙	tʰ u m p ʌ ŋ tʰ u m p ʌ ŋ
퉁	tʰ u ŋ
퉁탕	tʰ u ŋ tʰ ɐ ŋ
퉁탕퉁탕	tʰ u ŋ tʰ ɐ ŋ tʰ u ŋ tʰ ɐ ŋ
퉁퉁	tʰ u ŋ tʰ u ŋ
퉤	tʰ w e
퉤퉤	tʰ w e tʰ w e
트레트레	tʰ ɨ ɭ e tʰ ɨ ɭ e
티격태격	tʰ i k j ʌ k tʰ ɛ k j ʌ k
티석티석	tʰ i s ʌ k tʰ i s ʌ k
티적티적	tʰ i tɕ ʌ k tʰ i tɕ ʌ k
팅팅	tʰ i ŋ tʰ i ŋ
파니	pʰ ɐ n i
파닥	pʰ ɐ t ɐ k
파닥파닥	pʰ ɐ t ɐ k pʰ ɐ t ɐ k
파드닥	pʰ ɐ t ɨ t ɐ k
파드닥파드닥	pʰ ɐ t ɨ t ɐ k pʰ ɐ t ɨ t ɐ k
파드득	pʰ ɐ t ɨ t ɨ k
파드득파드득	pʰ ɐ t ɨ t ɨ k pʰ ɐ t ɨ t ɨ k
파들짝	pʰ ɐ t ɨ ɭ tɕ͈ ɐ k
파들파들	pʰ ɐ t ɨ ɭ pʰ ɐ t ɨ ɭ
파딱	pʰ ɐ t͈ ɐ k
파딱파딱	pʰ ɐ t͈ ɐ k pʰ ɐ t͈ ɐ k
파뜩	pʰ ɐ t͈ ɨ k
파뜩파뜩	pʰ ɐ t͈ ɨ k pʰ ɐ t͈ ɨ k
파르르	pʰ ɐ ɭ ɨ ɭ ɨ
파름파름	pʰ ɐ ɭ ɨ m pʰ ɐ ɭ ɨ m
파릇파릇	pʰ ɐ ɭ ɨ t pʰ ɐ ɭ ɨ t
파릿파릿	pʰ ɐ ɭ i t pʰ ɐ ɭ i t
파삭	pʰ ɐ s ɐ k
파삭파삭	pʰ ɐ s ɐ k pʰ ɐ s ɐ k
파슬파슬	pʰ ɐ s ɨ ɭ pʰ ɐ s ɨ ɭ
팍	pʰ ɐ k
팍삭	pʰ ɐ k s͈ ɐ k
팍삭팍삭	pʰ ɐ k s͈ ɐ k pʰ ɐ k s͈ ɐ k
팍신팍신	pʰ ɐ k s͈ i n pʰ ɐ k s͈ i n
팍팍	pʰ ɐ k pʰ ɐ k
판둥판둥	pʰ ɐ n t u ŋ pʰ ɐ n t u ŋ
판들판들	pʰ ɐ n t ɨ ɭ pʰ ɐ n t ɨ ɭ
팔딱	pʰ ɐ ɭ t͈ ɐ k
팔딱팔딱	pʰ ɐ ɭ t͈ ɐ k pʰ ɐ ɭ t͈ ɐ k
팔락	pʰ ɐ ɭ ɭ ɐ k
팔락팔락	pʰ ɐ ɭ ɭ ɐ k pʰ ɐ ɭ ɭ ɐ k
팔랑	pʰ ɐ ɭ ɭ ɐ ŋ
팔랑팔랑	pʰ ɐ ɭ ɭ ɐ ŋ pʰ ɐ ɭ ɭ ɐ ŋ
팔싹	pʰ ɐ ɭ s͈ ɐ k
팔싹팔싹	pʰ ɐ ɭ s͈ ɐ k pʰ ɐ ɭ s͈ ɐ k
팔짝	pʰ ɐ ɭ tɕ͈ ɐ k
팔짝팔짝	pʰ ɐ ɭ tɕ͈ ɐ k pʰ ɐ ɭ tɕ͈ ɐ k
팔팔	pʰ ɐ ɭ pʰ ɐ ɭ
팡	pʰ ɐ ŋ
팡당	pʰ ɐ ŋ t ɐ ŋ
팡당팡당	pʰ ɐ ŋ t ɐ ŋ pʰ ɐ ŋ t ɐ ŋ
팡팡	pʰ ɐ ŋ pʰ ɐ ŋ
패둥패둥	pʰ ɛ t u ŋ pʰ ɛ t u ŋ
팩	pʰ ɛ k
팩팩	pʰ ɛ k pʰ ɛ k
팬둥팬둥	pʰ ɛ n t u ŋ pʰ ɛ n t u ŋ
팬들팬들	pʰ ɛ n t ɨ ɭ pʰ ɛ n t ɨ ɭ
팽	pʰ ɛ ŋ
팽그르르	pʰ ɛ ŋ k ɨ ɭ ɨ ɭ ɨ
팽글팽글	pʰ ɛ ŋ k ɨ ɭ pʰ ɛ ŋ k ɨ ɭ
팽팽	pʰ ɛ ŋ pʰ ɛ ŋ
퍅	pʰ j ɐ k
퍅퍅	pʰ j ɐ k pʰ j ɐ k
퍼덕	pʰ ʌ t ʌ k
퍼덕퍼덕	pʰ ʌ t ʌ k pʰ ʌ t ʌ k
퍼드덕	pʰ ʌ t ɨ t ʌ k
퍼드덕퍼드덕	pʰ ʌ t ɨ t ʌ k pʰ ʌ t ɨ t ʌ k
퍼들퍼들	pʰ ʌ t ɨ ɭ pʰ ʌ t ɨ ɭ
퍼떡	pʰ ʌ t͈ ʌ k
퍼떡퍼떡	pʰ ʌ t͈ ʌ k pʰ ʌ t͈ ʌ k
퍼뜩	pʰ ʌ t͈ ɨ k
퍼뜩퍼뜩	pʰ ʌ t͈ ɨ k pʰ ʌ t͈ ɨ k
퍼르르	pʰ ʌ ɭ ɨ ɭ ɨ
퍼석	pʰ ʌ s ʌ k
퍼석퍼석	pʰ ʌ s ʌ k pʰ ʌ s ʌ k
퍼슬퍼슬	pʰ ʌ s ɨ ɭ pʰ ʌ s ɨ ɭ
퍽	pʰ ʌ k
퍽석	pʰ ʌ k s͈ ʌ k
퍽석퍽석	pʰ ʌ k s͈ ʌ k pʰ ʌ k s͈ ʌ k
퍽신퍽신	pʰ ʌ k s͈ i n pʰ ʌ k s͈ i n
퍽퍽	pʰ ʌ k pʰ ʌ k
펀둥펀둥	pʰ ʌ n t u ŋ pʰ ʌ n t u ŋ
펀들펀들	pʰ ʌ n t ɨ ɭ pʰ ʌ n t ɨ ɭ
펀쩍	pʰ ʌ n tɕ͈ ʌ k
펀펀	pʰ ʌ n pʰ ʌ n
펄떡	pʰ ʌ ɭ t͈ ʌ k
펄떡펄떡	pʰ ʌ ɭ t͈ ʌ k pʰ ʌ ɭ t͈ ʌ k
펄럭	pʰ ʌ ɭ ɭ ʌ k
펄럭펄럭	pʰ ʌ ɭ ɭ ʌ k pʰ ʌ ɭ ɭ ʌ k
펄렁	pʰ ʌ ɭ ɭ ʌ ŋ
펄렁펄렁	pʰ ʌ ɭ ɭ ʌ ŋ pʰ ʌ ɭ ɭ ʌ ŋ
펄썩	pʰ ʌ ɭ s͈ ʌ k
펄썩펄썩	pʰ ʌ ɭ s͈ ʌ k pʰ ʌ ɭ s͈ ʌ k
펄쩍	pʰ ʌ ɭ tɕ͈ ʌ k
펄쩍펄쩍	pʰ ʌ ɭ tɕ͈ ʌ k pʰ ʌ ɭ tɕ͈ ʌ k
펄펄	pʰ ʌ ɭ pʰ ʌ ɭ
펑	pʰ ʌ ŋ
펑덩	pʰ ʌ ŋ t ʌ ŋ
펑덩펑덩	pʰ ʌ ŋ t ʌ ŋ pʰ ʌ ŋ t ʌ ŋ
펑펑	pʰ ʌ ŋ pʰ ʌ ŋ
포갬포갬	pʰ o k ɛ m pʰ o k ɛ m
포근포근	pʰ o k ɨ n pʰ o k ɨ n
포닥	pʰ o t ɐ k
포닥포닥	pʰ o t ɐ k pʰ o t ɐ k
포도독	pʰ o t o t o k
포도독포도독	pʰ o t o t o k pʰ o t o t o k
포도동	pʰ o t o t o ŋ
포도동포도동	pʰ o t o t o ŋ pʰ o t o t o ŋ
포동포동	pʰ o t o ŋ pʰ o t o ŋ
포드닥	pʰ o t ɨ t ɐ k
포드닥포드닥	pʰ o t ɨ t ɐ k pʰ o t ɨ t ɐ k
포드득	pʰ o t ɨ t ɨ k
포드득포드득	pʰ o t ɨ t ɨ k pʰ o t ɨ t ɨ k
포딱	pʰ o t͈ ɐ k
포딱포딱	pʰ o t͈ ɐ k pʰ o t͈ ɐ k
포르르	pʰ o ɭ ɨ ɭ ɨ
포르릉	pʰ o ɭ ɨ ɭ ɨ ŋ
포르릉포르릉	pʰ o ɭ ɨ ɭ ɨ ŋ pʰ o ɭ ɨ ɭ ɨ ŋ
포삭	pʰ o s ɐ k
포삭포삭	pʰ o s ɐ k pʰ o s ɐ k
포슬포슬	pʰ o s ɨ ɭ pʰ o s ɨ ɭ
폭	pʰ o k
폭삭	pʰ o k s͈ ɐ k
폭삭폭삭	pʰ o k s͈ ɐ k pʰ o k s͈ ɐ k
폭신폭신	pʰ o k s͈ i n pʰ o k s͈ i n
폭폭	pʰ o k pʰ o k
폴딱	pʰ o ɭ t͈ ɐ k
폴딱폴딱	pʰ o ɭ t͈ ɐ k pʰ o ɭ t͈ ɐ k
폴락	pʰ o ɭ ɭ ɐ k
폴락폴락	pʰ o ɭ ɭ ɐ k pʰ o ɭ ɭ ɐ k
폴랑	pʰ o ɭ ɭ ɐ ŋ
폴랑폴랑	pʰ o ɭ ɭ ɐ ŋ pʰ o ɭ ɭ ɐ ŋ
폴싹	pʰ o ɭ s͈ ɐ k
폴싹폴싹	pʰ o ɭ s͈ ɐ k pʰ o ɭ s͈ ɐ k
폴짝	pʰ o ɭ tɕ͈ ɐ k
폴짝폴짝	pʰ o ɭ tɕ͈ ɐ k pʰ o ɭ tɕ͈ ɐ k
폴폴	pʰ o ɭ pʰ o ɭ
퐁	pʰ o ŋ
퐁당	pʰ o ŋ t ɐ ŋ
퐁당퐁당	pʰ o ŋ t ɐ ŋ pʰ o ŋ t ɐ ŋ
퐁퐁	pʰ o ŋ pʰ o ŋ
푸	pʰ u
푸근푸근	pʰ u k ɨ n pʰ u k ɨ n
푸다닥	pʰ u t ɐ t ɐ k
푸다닥푸다닥	pʰ u t ɐ t ɐ k pʰ u t ɐ t ɐ k
푸덕	pʰ u t ʌ k
푸덕푸덕	pʰ u t ʌ k pʰ u t ʌ k
푸두둑	pʰ u t u t u k
푸두둑푸두둑	pʰ u t u t u k pʰ u t u t u k
푸두둥	pʰ u t u t u ŋ
푸두둥푸두둥	pʰ u t u t u ŋ pʰ u t u t u ŋ
푸둥푸둥	pʰ u t u ŋ pʰ u t u ŋ
푸드덕	pʰ u t ɨ t ʌ k
푸드덕푸드덕	pʰ u t ɨ t ʌ k pʰ u t ɨ t ʌ k
푸드득	pʰ u t ɨ t ɨ k
푸드득푸드득	pʰ u t ɨ t ɨ k pʰ u t ɨ t ɨ k
푸들푸들	pʰ u t ɨ ɭ pʰ u t ɨ ɭ
푸떡	pʰ u t͈ ʌ k
푸떡푸떡	pʰ u t͈ ʌ k pʰ u t͈ ʌ k
푸르락누르락	pʰ u ɭ ɨ ɭ ɐ ŋ n u ɭ ɨ ɭ ɐ k
푸르르	pʰ u ɭ ɨ ɭ ɨ
푸르릉	pʰ u ɭ ɨ ɭ ɨ ŋ
푸르릉푸르릉	pʰ u ɭ ɨ ɭ ɨ ŋ pʰ u ɭ ɨ ɭ ɨ ŋ
푸름푸름	pʰ u ɭ ɨ m pʰ u ɭ ɨ m
푸릇푸릇	pʰ u ɭ ɨ t pʰ u ɭ ɨ t
푸석	pʰ u s ʌ k
푸석푸석	pʰ u s ʌ k pʰ u s ʌ k
푸설푸설	pʰ u s ʌ ɭ pʰ u s ʌ ɭ
푸수수	pʰ u s u s u
푸슬푸슬	pʰ u s ɨ ɭ pʰ u s ɨ ɭ
푸시시	pʰ u s i s i
푸푸	pʰ u pʰ u
푹	pʰ u k
푹석	pʰ u k s͈ ʌ k
푹석푹석	pʰ u k s͈ ʌ k pʰ u k s͈ ʌ k
푹신	pʰ u k s͈ i n
푹신푹신	pʰ u k s͈ i n pʰ u k s͈ i n
푹푹	pʰ u k pʰ u k
풀떡	pʰ u ɭ t͈ ʌ k
풀떡풀떡	pʰ u ɭ t͈ ʌ k pʰ u ɭ t͈ ʌ k
풀럭	pʰ u ɭ ɭ ʌ k
풀럭풀럭	pʰ u ɭ ɭ ʌ k pʰ u ɭ ɭ ʌ k
풀렁	pʰ u ɭ ɭ ʌ ŋ
풀렁풀렁	pʰ u ɭ ɭ ʌ ŋ pʰ u ɭ ɭ ʌ ŋ
풀썩	pʰ u ɭ s͈ ʌ k
풀썩풀썩	pʰ u ɭ s͈ ʌ k pʰ u ɭ s͈ ʌ k
풀쑥	pʰ u ɭ s͈ u k
풀쑥풀쑥	pʰ u ɭ s͈ u k pʰ u ɭ s͈ u k
풀쩍	pʰ u ɭ tɕ͈ ʌ k
풀쩍풀쩍	pʰ u ɭ tɕ͈ ʌ k pʰ u ɭ tɕ͈ ʌ k
풀풀	pʰ u ɭ pʰ u ɭ
풋	pʰ u t
풍	pʰ u ŋ
풍덩	pʰ u ŋ t ʌ ŋ
풍덩실	pʰ u ŋ t ʌ ŋ s i ɭ
풍덩풍덩	pʰ u ŋ t ʌ ŋ pʰ u ŋ t ʌ ŋ
풍풍	pʰ u ŋ pʰ u ŋ
피	pʰ i
피근피근	pʰ i k ɨ n pʰ i k ɨ n
피둥피둥	pʰ i t u ŋ pʰ i t u ŋ
피뜩	pʰ i t͈ ɨ k
피뜩피뜩	pʰ i t͈ ɨ k pʰ i t͈ ɨ k
피식	pʰ i s i k
피식피식	pʰ i s i k pʰ i s i k
피지직	pʰ i tɕ i tɕ i k
픽	pʰ i k
픽픽	pʰ i k pʰ i k
핀둥핀둥	pʰ i n t u ŋ pʰ i n t u ŋ
핀들핀들	pʰ i n t ɨ ɭ pʰ i n t ɨ ɭ
핑	pʰ i ŋ
핑그르르	pʰ i ŋ k ɨ ɭ ɨ ɭ ɨ
핑글핑글	pʰ i ŋ k ɨ ɭ pʰ i ŋ k ɨ ɭ
핑핑	pʰ i ŋ pʰ i ŋ
하	h ɐ
하느작하느작	h ɐ n ɨ tɕ ɐ kʰ ɐ n ɨ tɕ ɐ k
하늑하늑	h ɐ n ɨ kʰ ɐ n ɨ k
하늘하늘	h ɐ n ɨ ɭ ɐ n ɨ ɭ
하동지동	h ɐ t o ŋ tɕ i t o ŋ
하동하동	h ɐ t o ŋ h ɐ t o ŋ
하들하들	h ɐ t ɨ ɭ ɐ t ɨ ɭ
하롱하롱	h ɐ ɭ o ŋ h ɐ ɭ o ŋ
하르르	h ɐ ɭ ɨ ɭ ɨ
하르르하르르	h ɐ ɭ ɨ ɭ ɨ ɐ ɭ ɨ ɭ ɨ
하마하마	h ɐ m ɐ ɐ m ɐ
하물하물	h ɐ m u ɭ ɐ m u ɭ
하박하박	h ɐ p ɐ kʰ ɐ p ɐ k
하분하분	h ɐ p u n ɐ p u n
하비작하비작	h ɐ p i tɕ ɐ kʰ ɐ p i tɕ ɐ k
하빗하빗	h ɐ p i tʰ ɐ p i t
하작하작	h ɐ tɕ ɐ kʰ ɐ tɕ ɐ k
하전하전	h ɐ tɕ ʌ n ɐ tɕ ʌ n
하하	h ɐ ɐ
학	h ɐ k
한닥한닥	h ɐ n t ɐ kʰ ɐ n t ɐ k
한댕한댕	h ɐ n t ɛ ŋ h ɐ n t ɛ ŋ
한드랑한드랑	h ɐ n t ɨ ɭ ɐ ŋ h ɐ n t ɨ ɭ ɐ ŋ
한드작한드작	h ɐ n t ɨ tɕ ɐ kʰ ɐ n t ɨ tɕ ɐ k
한들한들	h ɐ n t ɨ ɭ ɐ n t ɨ ɭ
한소끔	h ɐ n s o k͈ ɨ m
할근할근	h ɐ ɭ k ɨ n ɐ ɭ k ɨ n
할금	h ɐ ɭ k ɨ m
할금할금	h ɐ ɭ k ɨ m h ɐ ɭ k ɨ m
할긋	h ɐ ɭ k ɨ t
할긋할긋	h ɐ ɭ k ɨ tʰ ɐ ɭ k ɨ t
할기시	h ɐ ɭ k i s i
할기족	h ɐ ɭ k i tɕ o k
할기족족	h ɐ ɭ k i tɕ o k tɕ͈ o k
할기족할기족	h ɐ ɭ k i tɕ o kʰ ɐ ɭ k i tɕ o k
할깃	h ɐ ɭ k i t
할깃할깃	h ɐ ɭ k i tʰ ɐ ɭ k i t
할깃흘깃	h ɐ ɭ k i tʰ ɨ ɭ k i t
할끔	h ɐ ɭ k͈ ɨ m
할끔할끔	h ɐ ɭ k͈ ɨ m h ɐ ɭ k͈ ɨ m
할끗	h ɐ ɭ k͈ ɨ t
할끗할끗	h ɐ ɭ k͈ ɨ tʰ ɐ ɭ k͈ ɨ t
할낏	h ɐ ɭ k͈ i t
할낏할낏	h ɐ ɭ k͈ i tʰ ɐ ɭ k͈ i t
할딱할딱	h ɐ ɭ t͈ ɐ kʰ ɐ ɭ t͈ ɐ k
할랑할랑	h ɐ ɭ ɭ ɐ ŋ h ɐ ɭ ɭ ɐ ŋ
할래발딱	h ɐ ɭ ɭ ɛ p ɐ ɭ t͈ ɐ k
할래발딱할래발딱	h ɐ ɭ ɭ ɛ p ɐ ɭ t͈ ɐ kʰ ɐ ɭ ɭ ɛ p ɐ ɭ t͈ ɐ k
할짝할짝	h ɐ ɭ tɕ͈ ɐ kʰ ɐ ɭ tɕ͈ ɐ k
할쭉할쭉	h ɐ ɭ tɕ͈ u kʰ ɐ ɭ tɕ͈ u k
할할	h ɐ ɭ ɐ ɭ
함빡	h ɐ m p͈ ɐ k
함빡함빡	h ɐ m p͈ ɐ kʰ ɐ m p͈ ɐ k
함실함실	h ɐ m s i ɭ ɐ m s i ɭ
함씬	h ɐ m s͈ i n
함씬함씬	h ɐ m s͈ i n ɐ m s͈ i n
함초롬	h ɐ m tɕʰ o ɭ o m
함치르르	h ɐ m tɕʰ i ɭ ɨ ɭ ɨ
합죽합죽	h ɐ p tɕ͈ u kʰ ɐ p tɕ͈ u k
해	h ɛ
해끔해끔	h ɛ k͈ ɨ m h ɛ k͈ ɨ m
해끗	h ɛ k͈ ɨ t
해끗해끗	h ɛ k͈ ɨ tʰ ɛ k͈ ɨ t
해득해득	h ɛ t ɨ kʰ ɛ t ɨ k
해들해들	h ɛ t ɨ ɭ ɛ t ɨ ɭ
해뜩	h ɛ t͈ ɨ k
해뜩발긋	h ɛ t͈ ɨ k p͈ ɐ ɭ k ɨ t
해뜩해뜩	h ɛ t͈ ɨ kʰ ɛ t͈ ɨ k
해롱해롱	h ɛ ɭ o ŋ h ɛ ɭ o ŋ
해물해물	h ɛ m u ɭ ɛ m u ɭ
해반닥해반닥	h ɛ p ɐ n t ɐ kʰ ɛ p ɐ n t ɐ k
해발쪽	h ɛ p ɐ ɭ tɕ͈ o k
해발쪽해발쪽	h ɛ p ɐ ɭ tɕ͈ o kʰ ɛ p ɐ ɭ tɕ͈ o k
해작해작	h ɛ tɕ ɐ kʰ ɛ tɕ ɐ k
해족해족	h ɛ tɕ o kʰ ɛ tɕ o k
해죽	h ɛ tɕ u k
해죽해죽	h ɛ tɕ u kʰ ɛ tɕ u k
해쭉	h ɛ tɕ͈ u k
해쭉해쭉	h ɛ tɕ͈ u kʰ ɛ tɕ͈ u k
해해	h ɛ ɛ
핼금	h ɛ ɭ k ɨ m
핼금핼금	h ɛ ɭ k ɨ m h ɛ ɭ k ɨ m
핼긋	h ɛ ɭ k ɨ t
핼긋핼긋	h ɛ ɭ k ɨ tʰ ɛ ɭ k ɨ t
핼끔	h ɛ ɭ k͈ ɨ m
핼끔핼끔	h ɛ ɭ k͈ ɨ m h ɛ ɭ k͈ ɨ m
핼끗	h ɛ ɭ k͈ ɨ t
핼끗핼끗	h ɛ ɭ k͈ ɨ tʰ ɛ ɭ k͈ ɨ t
허	h ʌ
허겁지겁	h ʌ k ʌ p tɕ͈ i k ʌ p
허덕지덕	h ʌ t ʌ k tɕ͈ i t ʌ k
허덕허덕	h ʌ t ʌ kʰ ʌ t ʌ k
허둥지둥	h ʌ t u ŋ tɕ i t u ŋ
허둥허둥	h ʌ t u ŋ h ʌ t u ŋ
허든허든	h ʌ t ɨ n ʌ t ɨ n
허룽허룽	h ʌ ɭ u ŋ h ʌ ɭ u ŋ
허방지방	h ʌ p ɐ ŋ tɕ i p ɐ ŋ
허벅허벅	h ʌ p ʌ kʰ ʌ p ʌ k
허분허분	h ʌ p u n ʌ p u n
허비적허비적	h ʌ p i tɕ ʌ kʰ ʌ p i tɕ ʌ k
허빗허빗	h ʌ p i tʰ ʌ p i t
허영허영	h ʌ j ʌ ŋ h ʌ j ʌ ŋ
허우적허우적	h ʌ u tɕ ʌ kʰ ʌ u tɕ ʌ k
허위허위	h ʌ w i ʌ w i
허적허적	h ʌ tɕ ʌ kʰ ʌ tɕ ʌ k
허전허전	h ʌ tɕ ʌ n ʌ tɕ ʌ n
허정허정	h ʌ tɕ ʌ ŋ h ʌ tɕ ʌ ŋ
허청허청	h ʌ tɕʰ ʌ ŋ h ʌ tɕʰ ʌ ŋ
허허	h ʌ ʌ
헉	h ʌ k
헉헉	h ʌ kʰ ʌ k
헐근할근	h ʌ ɭ k ɨ n ɐ ɭ k ɨ n
헐근헐근	h ʌ ɭ k ɨ n ʌ ɭ k ɨ n
헐금씨금	h ʌ ɭ k ɨ m s͈ i k ɨ m
헐떡헐떡	h ʌ ɭ t͈ ʌ kʰ ʌ ɭ t͈ ʌ k
헐렁헐렁	h ʌ ɭ ɭ ʌ ŋ h ʌ ɭ ɭ ʌ ŋ
헐레벌떡	h ʌ ɭ ɭ e p ʌ ɭ t͈ ʌ k
헐레벌떡헐레벌떡	h ʌ ɭ ɭ e p ʌ ɭ t͈ ʌ kʰ ʌ ɭ ɭ e p ʌ ɭ t͈ ʌ k
헐씨근헐씨근	h ʌ ɭ s͈ i k ɨ n ʌ ɭ s͈ i k ɨ n
헐헐	h ʌ ɭ ʌ ɭ
헙신헙신	h ʌ p s͈ i n ʌ p s͈ i n
헛헛	h ʌ tʰ ʌ t
헝겁지겁	h ʌ ŋ k ʌ p tɕ͈ i k ʌ p
헤	h e
헤근헤근	h e k ɨ n e k ɨ n
헤벌쭉	h e p ʌ ɭ tɕ͈ u k
헤벌쭉헤벌쭉	h e p ʌ ɭ tɕ͈ u kʰ e p ʌ ɭ tɕ͈ u k
헤실바실	h e s i ɭ p ɐ s i ɭ
헤실헤실	h e s i ɭ e s i ɭ
헤싱헤싱	h e s i ŋ h e s i ŋ
헤적헤적	h e tɕ ʌ kʰ e tɕ ʌ k
헤죽헤죽	h e tɕ u kʰ e tɕ u k
헤헤	h e e
헬렐레	h e ɭ ɭ e ɭ ɭ e
헹	h e ŋ
헹글헹글	h e ŋ k ɨ ɭ e ŋ k ɨ ɭ
호	h o
호드득	h o t ɨ t ɨ k
호드득호드득	h o t ɨ t ɨ kʰ o t ɨ t ɨ k
호락호락	h o ɭ ɐ kʰ o ɭ ɐ k
호로로	h o ɭ o ɭ o
호로록	h o ɭ o ɭ o k
호로록호로록	h o ɭ o ɭ o kʰ o ɭ o ɭ o k
호르르	h o ɭ ɨ ɭ ɨ
호르르호르르	h o ɭ ɨ ɭ ɨ o ɭ ɨ ɭ ɨ
호리호리	h o ɭ i o ɭ i
호물호물	h o m u ɭ o m u ɭ
호비작호비작	h o p i tɕ ɐ kʰ o p i tɕ ɐ k
호빗호빗	h o p i tʰ o p i t
호호	h o o
혹	h o k
혹혹	h o kʰ o k
홀까닥	h o ɭ k͈ ɐ t ɐ k
홀까닥홀까닥	h o ɭ k͈ ɐ t ɐ kʰ o ɭ k͈ ɐ t ɐ k
홀딱	h o ɭ t͈ ɐ k
홀딱홀딱	h o ɭ t͈ ɐ kʰ o ɭ t͈ ɐ k
홀랑	h o ɭ ɭ ɐ ŋ
홀랑홀랑	h o ɭ ɭ ɐ ŋ h o ɭ ɭ ɐ ŋ
홀짝	h o ɭ tɕ͈ ɐ k
홀짝홀짝	h o ɭ tɕ͈ ɐ kʰ o ɭ tɕ͈ ɐ k
홀쭉홀쭉	h o ɭ tɕ͈ u kʰ o ɭ tɕ͈ u k
홀홀	h o ɭ o ɭ
홈착홈착	h o m tɕʰ ɐ kʰ o m tɕʰ ɐ k
홈치작홈치작	h o m tɕʰ i tɕ ɐ kʰ o m tɕʰ i tɕ ɐ k
홍알홍알	h o ŋ ɐ ɭ o ŋ ɐ ɭ
홍홍	h o ŋ h o ŋ
화끈	h w ɐ k͈ ɨ n
화끈화끈	h w ɐ k͈ ɨ n w ɐ k͈ ɨ n
화다닥	h w ɐ t ɐ t ɐ k
화닥닥	h w ɐ t ɐ k t͈ ɐ k
화닥닥화닥닥	h w ɐ t ɐ k t͈ ɐ kʰ w ɐ t ɐ k t͈ ɐ k
화드득	h w ɐ t ɨ t ɨ k
화드득화드득	h w ɐ t ɨ t ɨ kʰ w ɐ t ɨ t ɨ k
화들짝	h w ɐ t ɨ ɭ tɕ͈ ɐ k
화들화들	h w ɐ t ɨ ɭ w ɐ t ɨ ɭ
화르르	h w ɐ ɭ ɨ ɭ ɨ
화르르화르르	h w ɐ ɭ ɨ ɭ ɨ w ɐ ɭ ɨ ɭ ɨ
확	h w ɐ k
확확	h w ɐ kʰ w ɐ k
활딱	h w ɐ ɭ t͈ ɐ k
활딱활딱	h w ɐ ɭ t͈ ɐ kʰ w ɐ ɭ t͈ ɐ k
활싹	h w ɐ ɭ s͈ ɐ k
활씬	h w ɐ ɭ s͈ i n
활짝	h w ɐ ɭ tɕ͈ ɐ k
활찐	h w ɐ ɭ tɕ͈ i n
활활	h w ɐ ɭ w ɐ ɭ
홧홧	h w ɐ tʰ w ɐ t
홰홰	h w ɛ w ɛ
홱	h w ɛ k
홱홱	h w ɛ kʰ w ɛ k
횅횅	h w ɛ ŋ h w ɛ ŋ
회	h w e
회똑	h w e t͈ o k
회똑회똑	h w e t͈ o kʰ w e t͈ o k
회똘회똘	h w e t͈ o ɭ w e t͈ o ɭ
회창회창	h w e tɕʰ ɐ ŋ h w e tɕʰ ɐ ŋ
회회	h w e w e
회회찬찬	h w e w e tɕʰ ɐ n tɕʰ ɐ n
획	h w e k
획획	h w e kʰ w e k
횡	h w e ŋ
횡횡	h w e ŋ h w e ŋ
후	h u
후끈	h u k͈ ɨ n
후끈후끈	h u k͈ ɨ n u k͈ ɨ n
후다닥	h u t ɐ t ɐ k
후다닥후다닥	h u t ɐ t ɐ kʰ u t ɐ t ɐ k
후닥닥	h u t ɐ k t͈ ɐ k
후닥닥후닥닥	h u t ɐ k t͈ ɐ kʰ u t ɐ k t͈ ɐ k
후두두	h u t u t u
후드득	h u t ɨ t ɨ k
후드득후드득	h u t ɨ t ɨ kʰ u t ɨ t ɨ k
후들후들	h u t ɨ ɭ u t ɨ ɭ
후딱	h u t͈ ɐ k
후딱후딱	h u t͈ ɐ kʰ u t͈ ɐ k
후루루	h u ɭ u ɭ u
후루룩	h u ɭ u ɭ u k
후루룩후루룩	h u ɭ u ɭ u kʰ u ɭ u ɭ u k
후르르	h u ɭ ɨ ɭ ɨ
후르르후르르	h u ɭ ɨ ɭ ɨ u ɭ ɨ ɭ ɨ
후리후리	h u ɭ i u ɭ i
후물후물	h u m u ɭ u m u ɭ
후비적후비적	h u p i tɕ ʌ kʰ u p i tɕ ʌ k
후빗후빗	h u p i tʰ u p i t
후후	h u u
훅	h u k
훅훅	h u kʰ u k
훌근번쩍	h u ɭ k ɨ n p ʌ n tɕ͈ ʌ k
훌근번쩍훌근번쩍	h u ɭ k ɨ n p ʌ n tɕ͈ ʌ kʰ u ɭ k ɨ n p ʌ n tɕ͈ ʌ k
훌꺼덕	h u ɭ k͈ ʌ t ʌ k
훌꺼덕훌꺼덕	h u ɭ k͈ ʌ t ʌ kʰ u ɭ k͈ ʌ t ʌ k
훌떡	h u ɭ t͈ ʌ k
훌떡훌떡	h u ɭ t͈ ʌ kʰ u ɭ t͈ ʌ k
훌렁	h u ɭ ɭ ʌ ŋ
훌렁훌렁	h u ɭ ɭ ʌ ŋ h u ɭ ɭ ʌ ŋ
훌쩍	h u ɭ tɕ͈ ʌ k
훌쩍훌쩍	h u ɭ tɕ͈ ʌ kʰ u ɭ tɕ͈ ʌ k
훌쭉훌쭉	h u ɭ tɕ͈ u kʰ u ɭ tɕ͈ u k
훌훌	h u ɭ u ɭ
훔척훔척	h u m tɕʰ ʌ kʰ u m tɕʰ ʌ k
훔치적훔치적	h u m tɕʰ i tɕ ʌ kʰ u m tɕʰ i tɕ ʌ k
훗훗	h u tʰ u t
훨떡	h w ʌ ɭ t͈ ʌ k
훨떡훨떡	h w ʌ ɭ t͈ ʌ kʰ w ʌ ɭ t͈ ʌ k
훨썩	h w ʌ ɭ s͈ ʌ k
훨씬	h w ʌ ɭ s͈ i n
훨쩍	h w ʌ ɭ tɕ͈ ʌ k
훨찐	h w ʌ ɭ tɕ͈ i n
훨훨	h w ʌ ɭ w ʌ ɭ
휘	h w i
휘끈	h w i k͈ ɨ n
휘딱	h w i t͈ ɐ k
휘딱휘딱	h w i t͈ ɐ kʰ w i t͈ ɐ k
휘뚜루마뚜루	h w i t͈ u ɭ u m ɐ t͈ u ɭ u
휘뚝	h w i t͈ u k
휘뚝휘뚝	h w i t͈ u kʰ w i t͈ u k
휘뚤휘뚤	h w i t͈ u ɭ w i t͈ u ɭ
휘리릭	h w i ɭ i ɭ i k
휘영청	h w i j ʌ ŋ tɕʰ ʌ ŋ
휘영휘영	h w i j ʌ ŋ h w i j ʌ ŋ
휘우뚱	h w i u t͈ u ŋ
휘우뚱휘우뚱	h w i u t͈ u ŋ h w i u t͈ u ŋ
휘우청휘우청	h w i u tɕʰ ʌ ŋ h w i u tɕʰ ʌ ŋ
휘적	h w i tɕ ʌ k
휘적휘적	h w i tɕ ʌ kʰ w i tɕ ʌ k
휘정휘정	h w i tɕ ʌ ŋ h w i tɕ ʌ ŋ
휘청	h w i tɕʰ ʌ ŋ
휘청휘청	h w i tɕʰ ʌ ŋ h w i tɕʰ ʌ ŋ
휘휘	h w i w i
휘휘친친	h w i w i tɕʰ i n tɕʰ i n
휙	h w i k
휙휙	h w i kʰ w i k
휭	h w i ŋ
휭하니	h w i ŋ h ɐ n i
휭휭	h w i ŋ h w i ŋ
흐느적흐느적	h ɨ n ɨ tɕ ʌ kʰ ɨ n ɨ tɕ ʌ k
흐늑흐늑	h ɨ n ɨ kʰ ɨ n ɨ k
흐늘쩍흐늘쩍	h ɨ n ɨ ɭ tɕ͈ ʌ kʰ ɨ n ɨ ɭ tɕ͈ ʌ k
흐늘흐늘	h ɨ n ɨ ɭ ɨ n ɨ ɭ
흐둥하둥	h ɨ t u ŋ h ɐ t u ŋ
흐르르	h ɨ ɭ ɨ ɭ ɨ
흐르르흐르르	h ɨ ɭ ɨ ɭ ɨ ɨ ɭ ɨ ɭ ɨ
흐리마리	h ɨ ɭ i m ɐ ɭ i
흐릿흐릿	h ɨ ɭ i tʰ ɨ ɭ i t
흐물흐물	h ɨ m u ɭ ɨ m u ɭ
흐뭇흐뭇	h ɨ m u tʰ ɨ m u t
흐슬부슬	h ɨ s ɨ ɭ p u s ɨ ɭ
흐지부지	h ɨ tɕ i p u tɕ i
흐흐	h ɨ ɨ
흑	h ɨ k
흑죽학죽	h ɨ k tɕ͈ u kʰ ɐ k tɕ͈ u k
흑흑	h ɨ kʰ ɨ k
흔덕흔덕	h ɨ n t ʌ kʰ ɨ n t ʌ k
흔뎅흔뎅	h ɨ n t e ŋ h ɨ n t e ŋ
흔드렁흔드렁	h ɨ n t ɨ ɭ ʌ ŋ h ɨ n t ɨ ɭ ʌ ŋ
흔드적흔드적	h ɨ n t ɨ tɕ ʌ kʰ ɨ n t ɨ tɕ ʌ k
흔들흔들	h ɨ n t ɨ ɭ ɨ n t ɨ ɭ
흔전만전	h ɨ n tɕ ʌ n m ɐ n tɕ ʌ n
흔전흔전	h ɨ n tɕ ʌ n ɨ n tɕ ʌ n
흘근번쩍	h ɨ ɭ k ɨ n p ʌ n tɕ͈ ʌ k
흘근번쩍흘근번쩍	h ɨ ɭ k ɨ n p ʌ n tɕ͈ ʌ kʰ ɨ ɭ k ɨ n p ʌ n tɕ͈ ʌ k
흘근흘근	h ɨ ɭ k ɨ n ɨ ɭ k ɨ n
흘금	h ɨ ɭ k ɨ m
흘금흘금	h ɨ ɭ k ɨ m h ɨ ɭ k ɨ m
흘긋	h ɨ ɭ k ɨ t
흘긋흘긋	h ɨ ɭ k ɨ tʰ ɨ ɭ k ɨ t
흘기죽	h ɨ ɭ k i tɕ u k
흘기죽죽	h ɨ ɭ k i tɕ u k tɕ͈ u k
흘기죽흘기죽	h ɨ ɭ k i tɕ u kʰ ɨ ɭ k i tɕ u k
흘깃	h ɨ ɭ k i t
흘깃할깃	h ɨ ɭ k i tʰ ɐ ɭ k i t
흘깃흘깃	h ɨ ɭ k i tʰ ɨ ɭ k i t
흘끔	h ɨ ɭ k͈ ɨ m
흘끔흘끔	h ɨ ɭ k͈ ɨ m h ɨ ɭ k͈ ɨ m
흘끗	h ɨ ɭ k͈ ɨ t
흘끗흘끗	h ɨ ɭ k͈ ɨ tʰ ɨ ɭ k͈ ɨ t
흘낏	h ɨ ɭ k͈ i t
흘낏흘낏	h ɨ ɭ k͈ i tʰ ɨ ɭ k͈ i t
흘림흘림	h ɨ ɭ ɭ i m h ɨ ɭ ɭ i m
흘미죽죽	h ɨ ɭ m i tɕ u k tɕ͈ u k
흘쩍흘쩍	h ɨ ɭ tɕ͈ ʌ kʰ ɨ ɭ tɕ͈ ʌ k
흘쭉흘쭉	h ɨ ɭ tɕ͈ u kʰ ɨ ɭ tɕ͈ u k
흘흘	h ɨ ɭ ɨ ɭ
흠	h ɨ m
흠뻑	h ɨ m p͈ ʌ k
흠뻑흠뻑	h ɨ m p͈ ʌ kʰ ɨ m p͈ ʌ k
흠실흠실	h ɨ m s i ɭ ɨ m s i ɭ
흠씬	h ɨ m s͈ i n
흠씬흠씬	h ɨ m s͈ i n ɨ m s͈ i n
흠치르르	h ɨ m tɕʰ i ɭ ɨ ɭ ɨ
흠칫	h ɨ m tɕʰ i t
흠칫흠칫	h ɨ m tɕʰ i tʰ ɨ m tɕʰ i t
흠흠	h ɨ m h ɨ m
흥	h ɨ ŋ
흥덩흥덩	h ɨ ŋ t ʌ ŋ h ɨ ŋ t ʌ ŋ
흥뚱항뚱	h ɨ ŋ t͈ u ŋ h ɐ ŋ t͈ u ŋ
흥얼흥얼	h ɨ ŋ ʌ ɭ ɨ ŋ ʌ ɭ
흥이야항이야	h ɨ ŋ i j ɐ ɐ ŋ i j ɐ
흥청망청	h ɨ ŋ tɕʰ ʌ ŋ m ɐ ŋ tɕʰ ʌ ŋ
흥청흥청	h ɨ ŋ tɕʰ ʌ ŋ h ɨ ŋ tɕʰ ʌ ŋ
흥흥	h ɨ ŋ h ɨ ŋ
희끈희끈	h i k͈ ɨ n i k͈ ɨ n
희끔희끔	h i k͈ ɨ m h i k͈ ɨ m
희끗	h i k͈ ɨ t
희끗희끗	h i k͈ ɨ tɕʰ i k͈ ɨ t
희뜩	h i t͈ ɨ k
희뜩번뜩	h i t͈ ɨ k p͈ ʌ n t͈ ɨ k
희뜩희뜩	h i t͈ ɨ kʰ i t͈ ɨ k
희룽해롱	h i ɭ u ŋ h ɛ ɭ o ŋ
희룽희룽	h i ɭ u ŋ h i ɭ u ŋ
희번덕희번덕	h i p ʌ n t ʌ kʰ i p ʌ n t ʌ k
희치희치	h i tɕʰ i i tɕʰ i
희희	h i i
히	h i
히뜩	h i t͈ ɨ k
히물	h i m u ɭ
히물쩍	h i m u ɭ tɕ͈ ʌ k
히죽	h i tɕ u k
히죽해죽	h i tɕ u kʰ ɛ tɕ u k
히쭉	h i tɕ͈ u k
히쭉벌쭉	h i tɕ͈ u k p͈ ʌ ɭ tɕ͈ u k
히쭉해쭉	h i tɕ͈ u kʰ ɛ tɕ͈ u k
히힝	h i i ŋ
힐금	h i ɭ k ɨ m
힐금힐금	h i ɭ k ɨ m h i ɭ k ɨ m
힐긋	h i ɭ k ɨ t
힐긋힐긋	h i ɭ k ɨ tɕʰ i ɭ k ɨ t
힐끔	h i ɭ k͈ ɨ m
힐끔힐끔	h i ɭ k͈ ɨ m h i ɭ k͈ ɨ m
힐끗	h i ɭ k͈ ɨ t
힐끗힐끗	h i ɭ k͈ ɨ tɕʰ i ɭ k͈ ɨ t
힝	h i ŋ
힝뚱힝뚱	h i ŋ t͈ u ŋ h i ŋ t͈ u ŋ
힝힝	h i ŋ h i ŋ
기름	k i ɭ ɨ m
빠질	p͈ ɐ tɕ i ɭ
끄물	k͈ ɨ m u ɭ
옴지락	o m tɕ i ɭ ɐ k
그러	k ɨ ɭ ʌ
길	k i ɭ
리마리	ɭ i m ɐ ɭ i
쭐렁	tɕ͈ u ɭ ɭ ʌ ŋ
울고불	u ɭ k o p u ɭ
꿀	k͈ u ɭ
훌	h u ɭ
조금	tɕ o k ɨ m
도	t o
득	t ɨ k
쩍	tɕ͈ ʌ k
부질	p u tɕ i ɭ
바질	p ɐ tɕ i ɭ
적	tɕ ʌ k
짝	tɕ͈ ɐ k
위	w i
훨	h w ʌ ɭ
카랑카	kʰ ɐ ɭ ɐ ŋ kʰ ɐ
버	p ʌ
숨	s u m
둥	t u ŋ
지	tɕ i
함	h ɐ m
소	s o
중얼	tɕ u ŋ ʌ ɭ
겅불겅	k ʌ ŋ p u ɭ k ʌ ŋ
가닥	k ɐ t ɐ k
꿈	k͈ u m
우질	u tɕ i ɭ
나	n ɐ
고시	k o s i
배	p ɛ
릿	ɭ i t
벅	p ʌ k
촐싹	tɕʰ o ɭ s͈ ɐ k
답작	t ɐ p tɕ͈ ɐ k
등	t ɨ ŋ
모	m o
룩	ɭ u k
냅	n ɛ p
룽	ɭ u ŋ
바닥	p ɐ t ɐ k
굽	k u p
싹	s͈ ɐ k
울	u ɭ
들	t ɨ ɭ
아기	ɐ k i
월	w ʌ ɭ
후두	h u t u
바지	p ɐ tɕ i
쩔	tɕ͈ ʌ ɭ
이죽	i tɕ u k
와드등	w ɐ t ɨ t ɨ ŋ
토드락	tʰ o t ɨ ɭ ɐ k
주묵	tɕ u m u k
부등	p u t ɨ ŋ
불	p u ɭ
가당	k ɐ t ɐ ŋ
덜	t ʌ ɭ
똘	t͈ o ɭ
볼강	p o ɭ k ɐ ŋ
들새	t ɨ ɭ s͈ ɛ
홀	h o ɭ
한드작	h ɐ n t ɨ tɕ ɐ k
건	k ʌ n
갈	k ɐ ɭ
히	h i
다래	t ɐ ɭ ɛ
호로	h o ɭ o
드랑	t ɨ ɭ ɐ ŋ
거	k ʌ
이	i
성	s ʌ ŋ
휘리	h w i ɭ i
뻥	p͈ ʌ ŋ
꾼	k͈ u n
송	s o ŋ
렁	ɭ ʌ ŋ
기족	k i tɕ o k
춤	tɕʰ u m
우두	u t u
지끔	tɕ i k͈ ɨ m
락	ɭ ɐ k
둥둥	t u ŋ t u ŋ
추근	tɕʰ u k ɨ n
가	k ɐ
움지럭	u m tɕ i ɭ ʌ k
덩이	t ʌ ŋ i
비리	p i ɭ i
근처	k ɨ n tɕʰ ʌ
까닥	k͈ ɐ t ɐ k
씰	s͈ i ɭ
구슬	k u s ɨ ɭ
무시	m u s i
사물	s ɐ m u ɭ
집	tɕ i p
애	ɛ
근	k ɨ n
쌍	s͈ ɐ ŋ
비	p i
힝	h i ŋ
타발	tʰ ɐ p ɐ ɭ
너글	n ʌ k ɨ ɭ
똥	t͈ o ŋ
동실	t o ŋ s i ɭ
흔드적	h ɨ n t ɨ tɕ ʌ k
딱	t͈ ɐ k
긋	k ɨ t
쭐	tɕ͈ u ɭ
빠지	p͈ ɐ tɕ i
꺼	k͈ ʌ
파	pʰ ɐ
한	h ɐ n
다르	t ɐ ɭ ɨ
빵	p͈ ɐ ŋ
쏘삭	s͈ o s ɐ k
찔	tɕ͈ i ɭ
뚱	t͈ u ŋ
찐	tɕ͈ i n
직부	tɕ i k p͈ u
다물	t ɐ m u ɭ
수	s u
웃	u t
삐죽	p͈ i tɕ u k
신	s i n
드	t ɨ
북	p u k
옹	o ŋ
그럭	k ɨ ɭ ʌ k
땅	t͈ ɐ ŋ
하	h ɐ
스	s ɨ
느실	n ɨ s i ɭ
럭	ɭ ʌ k
리어리	ɭ i ʌ ɭ i
빨	p͈ ɐ ɭ
팔	pʰ ɐ ɭ
지직	tɕ i tɕ i k
끈	k͈ ɨ n
선	s ʌ n
말	m ɐ ɭ
줄	tɕ u ɭ
얼	ʌ ɭ
살	s ɐ ɭ
소리	s o ɭ i
움	u m
짜	tɕ͈ ɐ
뜩	t͈ ɨ k
부시	p u s i
허벅	h ʌ p ʌ k
고질	k o tɕ i ɭ
뺀들	p͈ ɛ n t ɨ ɭ
게	k e
더	t ʌ
멀	m ʌ ɭ
르	ɭ ɨ
휘	h w i
자리	tɕ ɐ ɭ i
딸	t͈ ɐ ɭ
늘	n ɨ ɭ
호드	h o t ɨ
노릇	n o ɭ ɨ t
융	j u ŋ
둘레	t u ɭ ɭ e
반송	p ɐ n s o ŋ
삼	s ɐ m
소락	s o ɭ ɐ k
해물	h ɛ m u ɭ
그륵	k ɨ ɭ ɨ k
걱실	k ʌ k s͈ i ɭ
시위	s i w i
해	h ɛ
나팔	n ɐ pʰ ɐ ɭ
둘	t u ɭ
생	s ɛ ŋ
부죽	p u tɕ u k
차	tɕʰ ɐ
못나	m o n n ɐ
툴	tʰ u ɭ
컹	kʰ ʌ ŋ
할	h ɐ ɭ
지금	tɕ i k ɨ m
옴실	o m s i ɭ
무	m u
뻘	p͈ ʌ ɭ
알	ɐ ɭ
씽	s͈ i ŋ
왜	w ɛ
두	t u
옴	o m
아르	ɐ ɭ ɨ
고	k o
발기	p ɐ ɭ k i
싱	s i ŋ
렛	ɭ e t
오	o
쫄	tɕ͈ o ɭ
삥	p͈ i ŋ
꼬약	k͈ o j ɐ k
둥싱	t u ŋ s i ŋ
휘정	h w i tɕ ʌ ŋ
쟁글	tɕ ɛ ŋ k ɨ ɭ
동기	t o ŋ k i
아름작	ɐ ɭ ɨ m tɕ ɐ k
한드랑	h ɐ n t ɨ ɭ ɐ ŋ
떡	t͈ ʌ k
질	tɕ i ɭ
덩	t ʌ ŋ
우	u
글	k ɨ ɭ
랑	ɭ ɐ ŋ
콩	kʰ o ŋ
튀	tʰ w i
떼	t͈ e
몰	m o ɭ
뒤	t w i
빠	p͈ ɐ
쏙닥	s͈ o k t͈ ɐ k
해족	h ɛ tɕ o k
다락	t ɐ ɭ ɐ k
펑	pʰ ʌ ŋ
삐	p͈ i
뚤휘뚤	t͈ u ɭ w i t͈ u ɭ
릭	ɭ i k
로니	ɭ o n i
중기	tɕ u ŋ k i
그물	k ɨ m u ɭ
자란	tɕ ɐ ɭ ɐ n
야	j ɐ
우뚤	u t͈ u ɭ
초	tɕʰ o
덕	t ʌ k
썩	s͈ ʌ k
오똘	o t͈ o ɭ
시물	s i m u ɭ
캉	kʰ ɐ ŋ
당	t ɐ ŋ
저축	tɕ ʌ tɕʰ u k
흥	h ɨ ŋ
벌렁	p ʌ ɭ ɭ ʌ ŋ
치르르	tɕʰ i ɭ ɨ ɭ ɨ
도손	t o s o n
박	p ɐ k
망	m ɐ ŋ
든	t ɨ n
뚜	t͈ u
우묵	u m u k
뱅	p ɛ ŋ
거니	k ʌ n i
작	tɕ ɐ k
두리	t u ɭ i
거든	k ʌ t ɨ n
로	ɭ o
깨	k͈ ɛ
어름	ʌ ɭ ɨ m
글자	k ɨ ɭ tɕ ɐ
넌들	n ʌ n t ɨ ɭ
때	t͈ ɛ
시설	s i s ʌ ɭ
부	p u
집적	tɕ i p tɕ͈ ʌ k
꼴	k͈ o ɭ
허허	h ʌ ʌ
으	ɨ
간들	k ɐ n t ɨ ɭ
직신	tɕ i k s͈ i n
쪼	tɕ͈ o
촐	tɕʰ o ɭ
적적	tɕ ʌ k tɕ͈ ʌ k
탈	tʰ ɐ ɭ
자금	tɕ ɐ k ɨ m
하늑	h ɐ n ɨ k
수리	s u ɭ i
두룩	t u ɭ u k
각	k ɐ k
럼	ɭ ʌ m
주근	tɕ u k ɨ n
애해	ɛ ɛ
잘	tɕ ɐ ɭ
절	tɕ ʌ ɭ
륵	ɭ ɨ k
쿵	kʰ u ŋ
야항	j ɐ ɐ ŋ
슬	s ɨ ɭ
손	s o n
고상	k o s ɐ ŋ
끗	k͈ ɨ t
서리	s ʌ ɭ i
늘썽	n ɨ ɭ s͈ ʌ ŋ
대각	t ɛ k ɐ k
회	h w e
조르	tɕ o ɭ ɨ
물	m u ɭ
거덩	k ʌ t ʌ ŋ
대	t ɛ
금	k ɨ m
깐죽	k͈ ɐ n tɕ u k
뜰먹	t͈ ɨ ɭ m ʌ k
깃	k i t
다	t ɐ
구구	k u k u
쌀	s͈ ɐ ɭ
그레	k ɨ ɭ e
해득	h ɛ t ɨ k
뿌	p͈ u
잠깐	tɕ ɐ m k͈ ɐ n
부지	p u tɕ i
보드	p o t ɨ
줄비	tɕ u ɭ p i
쌩	s͈ ɛ ŋ
처	tɕʰ ʌ
여흘	j ʌ ɨ ɭ
할딱	h ɐ ɭ t͈ ɐ k
도록	t o ɭ o k
덩그러	t ʌ ŋ k ɨ ɭ ʌ
털	tʰ ʌ ɭ
자기	tɕ ɐ k i
끔	k͈ ɨ m
어	ʌ
대충	t ɛ tɕʰ u ŋ
부풀	p u pʰ u ɭ
출썩	tɕʰ u ɭ s͈ ʌ k
기시	k i s i
철	tɕʰ ʌ ɭ
왈	w ɐ ɭ
쫄끔	tɕ͈ o ɭ k͈ ɨ m
호비작	h o p i tɕ ɐ k
휭	h w i ŋ
기	k i
듯	t ɨ t
조	tɕ o
두루	t u ɭ u
니	n i
하늘	h ɐ n ɨ ɭ
꼬	k͈ o
쑴길쑴	s͈ u m k i ɭ s͈ u m
칠	tɕʰ i ɭ
달	t ɐ ɭ
바당	p ɐ t ɐ ŋ
뺑	p͈ ɛ ŋ
술	s u ɭ
자칫	tɕ ɐ tɕʰ i t
아늘	ɐ n ɨ ɭ
덩펑	t ʌ ŋ pʰ ʌ ŋ
쫄딱	tɕ͈ o ɭ t͈ ɐ k
아	ɐ
그	k ɨ
근알	k ɨ n ɐ ɭ
딱딱이	t͈ ɐ k t͈ ɐ k i
올강	o ɭ k ɐ ŋ
새	s ɛ
루	ɭ u
차르	tɕʰ ɐ ɭ ɨ
씬	s͈ i n
너	n ʌ
