aw	ough	ɔ
baugh	baw	b ɔ
bif	biff	b ɪ f
blirt	blurt	b l ɹ̩ t
clop	klop	k l ɑ p
er	ur	ɹ̩
ew	ou	u
fissle	fistle	f ɪ s ə l
fiz	fizz	f ɪ z
ging	jing	d͡ʒ ɪ ŋ
gnap	knap	n æ p
gollar	goller	ɡ ɑ l ɹ̩
goo	gugg	ɡ u
jaup	jawp	d͡ʒ ɔ p
mm	murre	m
phoo	phu	f u
psst	pst	s t
quake	queck	k w e j k
scraugh	scraw	s k ɹ ɔ
snirt	snurt	s n ɹ̩ t
swap	swop	s w ɑ p
tcha	tchah	t͡ʃ ə
tewhit	tu-whit	t u w ɪ t
waw	wough	w ɔ
wee	whee	w i
week	wheak	w i k
whiz	whizz	w ɪ z
whuff	wuff	w ʌ f
yawp	yaup	j ɔ p
yuck	yuck	j ʌ k
